rosetta.id,skim.seq.id,wgs.id,N.ident,N.het,N.diff,N,pident,raw.reads
BW_20604,BW_20604_A_idx_824,BW_01001,8982467,451368,67149,9049616,0.992579906152924,1358372
BW_20604,BW_20604_B_idx_825,BW_01001,7416145,370065,55813,7471958,0.992530338098796,1136165
BW_20604,BW_20604_idx_1,BW_01001,10194994,519664,77091,10272085,0.992495097149216,1843181
BW_20605,BW_20605_idx_9,BW_01001,13004304,587722,6728,13011032,0.999482900357174,1958593
BW_20606,BW_20606_idx_17,BW_01001,10927818,488448,5588,10933406,0.999488905835931,1571534
BW_20607,BW_20607_idx_25,BW_01001,10707267,479114,5554,10712821,0.999481555791887,1541722
BW_20607,BW_20607_idx_826,BW_01001,9006869,401364,4433,9011302,0.99950806220899,1241071
TOWWC002,TOWWC002_idx_97,BW_01001,2912045,114875,960,2913005,0.999670443408096,251511
BW_20609,BW_20609_A_idx_827,BW_01002,2762166,115394,1199,2763365,0.999566108711661,329419
BW_20609,BW_20609_idx_33,BW_01002,11721000,519876,5622,11726622,0.999520578048819,1664141
BW_20611,BW_20611_idx_2,BW_01002,17403318,784640,8375,17411693,0.999519001397509,2663647
BW_20612,BW_20612_idx_10,BW_01002,10508674,470028,5189,10513863,0.999506461136121,1515922
BW_25575,BW_25575_idx_987,BW_01002,5872743,256555,2607,5875350,0.999556281753427,725991
TOWWC003,TOWWC003_idx_105,BW_01002,3421328,136064,1171,3422499,0.999657852347071,299065
BW_20614,BW_20614_idx_26,BW_01003,12167976,534344,5930,12173906,0.999512892575316,1684004
BW_20616,BW_20616_idx_34,BW_01003,12048211,530670,5783,12053994,0.999520242004434,1847506
BW_20616,BW_20616_idx_828,BW_01003,6822409,294523,3097,6825506,0.99954626074609,904413
BW_25583,BW_25583_idx_988,BW_01003,5106318,214842,2101,5108419,0.999588718153307,577137
TOWWC004,TOWWC004_idx_113,BW_01003,1480685,55225,480,1481165,0.999675930770711,183770
BW_20617,BW_20617_idx_11,BW_01004,9428258,410862,4903,9433161,0.999480237854522,1232395
BW_20618,BW_20618_idx_19,BW_01004,7885192,344078,3974,7889166,0.999496271215487,1075448
BW_20619,BW_20619_idx_27,BW_01004,8972995,389774,4576,8977571,0.999490285289863,1242211
BW_20620,BW_20620_idx_35,BW_01004,7798498,342682,4201,7802699,0.999461596557806,1106433
BW_25588,BW_25588_idx_4,BW_01004,11276099,492564,5709,11281808,0.999493964088026,1571048
TOWWC005,TOWWC005_idx_121,BW_01004,3033431,116963,1080,3034511,0.999644094221441,261183
BW_20625,BW_20625_A_idx_830,BW_01006,5301913,223665,2314,5304227,0.999563744161025,641468
BW_20627,BW_20627_idx_13,BW_01006,11342774,507120,10648,11353422,0.999062132985103,1727435
BW_20628,BW_20628_idx_21,BW_01006,15769117,695450,7887,15777004,0.999500095201852,2418664
BW_20629,BW_20629_idx_29,BW_01006,10898752,479018,5546,10904298,0.999491393210274,1656206
TOWWC007,TOWWC007_idx_137,BW_01006,2654611,101792,938,2655549,0.999646777370706,226148
BW_20631,BW_20631_idx_831,BW_01007,4561506,162284,1187,4562693,0.999739846621283,567705
BW_20632,BW_20632_idx_37,BW_01007,7798580,283408,2045,7800625,0.999737841519109,983752
BW_20633,BW_20633_idx_6,BW_01007,9040691,331947,2596,9043287,0.99971293623657,1382874
BW_20634,BW_20634_idx_14,BW_01007,5369879,189338,1516,5371395,0.999717764193473,646584
BW_20635,BW_20635_idx_22,BW_01007,11549654,415307,2773,11552427,0.999759963858677,1577298
TOWWC008,TOWWC008_idx_145,BW_01007,3786383,122407,848,3787231,0.999776089707757,304677
BW_20636,BW_20636_idx_30,BW_01008,13756612,484055,3205,13759817,0.99976707539061,1891655
BW_20637,BW_20637_idx_38,BW_01008,14719553,518208,3338,14722891,0.999773278223686,2039889
BW_20638,BW_20638_idx_7,BW_01008,9254481,326914,2292,9256773,0.999752397514771,1306004
BW_20639,BW_20639_idx_15,BW_01008,11346570,406498,2895,11349465,0.9997449218972,1669172
BW_20640,BW_20640_idx_23,BW_01008,15255971,530803,3505,15259476,0.999770306660596,2015718
BW_20640,BW_20640_idx_832,BW_01008,12450051,437514,2982,12453033,0.999760540263565,1677750
TOWWC009,TOWWC009_idx_153,BW_01008,2988395,93459,614,2989009,0.999794580745659,240570
BW_20641,BW_20641_A_idx_833,BW_01009,5943875,258226,2843,5946718,0.999521921167272,798042
BW_20641,BW_20641_B_idx_834,BW_01009,7523603,329060,3807,7527410,0.999494248353683,965790
BW_20641,BW_20641_idx_31,BW_01009,9742342,431232,5152,9747494,0.999471453893688,1354340
BW_20642,BW_20642_idx_39,BW_01009,17279676,788699,9192,17288868,0.999468328406464,2763050
BW_20643,BW_20643_idx_8,BW_01009,9594679,430682,5161,9599840,0.999462386873115,1384878
BW_20644,BW_20644_idx_16,BW_01009,14490680,667920,8142,14498822,0.999438437136479,2533979
BW_20644,BW_20644_idx_835,BW_01009,3870659,162015,1726,3872385,0.999554279855954,435436
TOWWC010,TOWWC010_idx_161,BW_01009,3362951,132788,1088,3364039,0.999676579254878,292671
BW_20647,BW_20647_idx_24,BW_01010,12327454,568839,6730,12334184,0.999454361958602,1796271
BW_20648,BW_20648_idx_32,BW_01010,11565424,641294,159605,11725029,0.986387666930291,1860891
BW_20648,BW_20648_idx_836,BW_01010,4874998,260057,67032,4942030,0.986436342960281,640008
BW_25592,BW_25592_idx_40,BW_01010,10698347,496146,5535,10703882,0.999482897886954,1519071
BW_25597,BW_25597_idx_989,BW_01010,3713038,163560,1776,3714814,0.999521914152364,428342
TOWWC011,TOWWC011_idx_169,BW_01010,1901990,77572,974,1902964,0.999488166880719,163849
BW_20649,BW_20649_A_idx_837,BW_01011,4044863,185896,2206,4047069,0.999454914161335,493179
BW_20650,BW_20650_idx_49,BW_01011,11141967,538913,6810,11148777,0.999389170668675,1791084
BW_20651,BW_20651_idx_57,BW_01011,14326456,694026,8788,14335244,0.999386965439863,2331998
BW_20652,BW_20652_idx_65,BW_01011,12087930,586898,7434,12095364,0.999385384350566,1958795
BW_25599,BW_25599_idx_990,BW_01011,7917139,376457,4518,7921657,0.999429664778467,1118793
TOWWC012,TOWWC012_idx_177,BW_01011,2948877,130017,1566,2950443,0.999469232247496,282687
BW_20653,BW_20653_idx_42,BW_01012,15681361,569889,4223,15685584,0.999730771898579,2290882
BW_20654,BW_20654_idx_50,BW_01012,14326494,528265,3979,14330473,0.999722339939512,2244529
BW_20655,BW_20655_idx_58,BW_01012,16576198,597715,4353,16580551,0.999737463489603,2342794
BW_20656,BW_20656_idx_66,BW_01012,13674044,502544,3830,13677874,0.999719985722927,2054771
BW_20657,BW_20657_idx_74,BW_01012,12365808,455621,3459,12369267,0.999720355296721,1870179
BW_20658,BW_20658_idx_43,BW_01012,4369071,165183,1409,4370480,0.999677609781992,753824
BW_20658,BW_20658_idx_838,BW_01012,6699617,238205,1783,6701400,0.999733936192437,860151
TOWWC013,TOWWC013_idx_185,BW_01012,2584069,81677,587,2584656,0.999772890473626,274775
BW_20670,BW_20670_idx_51,BW_01015,8413905,351187,66579,8480484,0.992149150921103,1132717
BW_20671,BW_20671_idx_59,BW_01015,11754433,435773,3521,11757954,0.999700543138713,1536964
BW_20672,BW_20672_idx_67,BW_01015,12642962,462612,3757,12646719,0.999702926901436,1584887
BW_20672,BW_20672_idx_839,BW_01015,4049314,143516,1272,4050586,0.999685971363156,453435
BW_20673,BW_20673_idx_75,BW_01015,10674046,389143,3165,10677211,0.999703574276091,1320138
TOWWC016,TOWWC016_idx_98,BW_01015,3689533,141025,28526,3718059,0.992327717230953,302953
BW_20675,BW_20675_idx_44,BW_01016,9453323,340092,2163,9455486,0.999771243910678,1204317
BW_20676,BW_20676_idx_52,BW_01016,8885232,316264,2126,8887358,0.99976078380099,1148429
BW_20677,BW_20677_idx_60,BW_01016,13426497,483040,3193,13429690,0.99976224320889,1799215
BW_20678,BW_20678_idx_68,BW_01016,12718339,451930,2984,12721323,0.999765433202191,1689589
BW_20678,BW_20678_idx_840,BW_01016,11066902,386629,2531,11069433,0.999771352335752,1368550
TOWWC017,TOWWC017_idx_106,BW_01016,5341580,177232,1122,5342702,0.999789993901962,461993
BW_20688,BW_20688_idx_76,BW_01019,15425454,544989,3498,15428952,0.999773283370121,2058811
BW_20689,BW_20689_idx_45,BW_01019,11362793,411818,2868,11365661,0.999747660958742,1713334
BW_20690,BW_20690_idx_53,BW_01019,8949347,316142,2179,8951526,0.999756577817011,1179049
BW_20691,BW_20691_idx_61,BW_01019,10539679,371026,2473,10542152,0.999765417914672,1418183
TOWWC020,TOWWC020_idx_114,BW_01019,4385541,139292,917,4386458,0.999790947502518,413677
BW_20693,BW_20693_idx_69,BW_01020,13015869,645874,8106,13023975,0.999377609370411,1887222
BW_20694,BW_20694_idx_77,BW_01020,10820539,539764,6761,10827300,0.999375559927221,1790832
BW_20695,BW_20695_idx_46,BW_01020,1625722,77962,1405,1627127,0.999136514851023,244358
TOWWC021,TOWWC021_idx_122,BW_01020,3484627,153941,1533,3486160,0.999560261146935,325732
BW_20697,BW_20697_idx_54,BW_01021,5533279,220658,2138,5535417,0.999613759902822,738804
BW_20699,BW_20699_idx_841,BW_01021,4534966,177556,1788,4536754,0.999605885617779,639209
BW_25603,BW_25603_idx_62,BW_01021,9340272,371035,3323,9343595,0.999644355304356,1185833
BW_25604,BW_25604_idx_70,BW_01021,13383892,536021,4852,13388744,0.999637606036832,1892116
TOWWC022,TOWWC022_idx_130,BW_01021,1158514,39998,271,1158785,0.999766134356244,161949
BW_20700,BW_20700_A_idx_842,BW_01022,3740437,173022,1897,3742334,0.999493097088608,454897
BW_20700,BW_20700_idx_78,BW_01022,9091272,432288,5051,9096323,0.99944472068549,1274906
BW_20701,BW_20701_idx_47,BW_01022,15012330,721228,8548,15020878,0.999430925409287,2272144
BW_20702,BW_20702_idx_55,BW_01022,8123299,382178,4331,8127630,0.999467126333261,1097668
BW_20703,BW_20703_idx_63,BW_01022,11468573,547333,6400,11474973,0.999442264482888,1669733
TOWWC023,TOWWC023_idx_138,BW_01022,2577083,108536,1058,2578141,0.999589626789225,250549
BW_20708,BW_20708_idx_71,BW_01024,16388442,631452,5048,16393490,0.999692072889909,2330425
BW_20709,BW_20709_idx_79,BW_01024,13611899,527304,4175,13616074,0.999693377107087,1984611
BW_20710,BW_20710_idx_48,BW_01024,7015107,291832,2870,7017977,0.999591050241401,1722142
BW_20711,BW_20711_idx_56,BW_01024,9267567,359980,2939,9270506,0.999682973076119,1433396
BW_20712,BW_20712_idx_64,BW_01024,12362151,479375,3927,12366078,0.999682437713881,1876901
BW_20713,BW_20713_idx_72,BW_01024,13090249,510780,4172,13094421,0.99968139102905,1989647
TOWWC025,TOWWC025_idx_146,BW_01024,3644717,125095,969,3645686,0.999734206401758,339101
TOWWC025,TOWWC025_idx_154,BW_01024,1480131,58812,14132,1494263,0.990542494862016,235551
BW_20714,BW_20714_idx_80,BW_01025,14301006,506214,3763,14304769,0.999736940876151,1917536
BW_20715,BW_20715_idx_289,BW_01025,11201815,398989,3131,11204946,0.999720569826932,1638344
BW_20715,BW_20715_idx_290,BW_01025,11043463,393639,3129,11046592,0.999716745218797,1537263
BW_20717,BW_20717_idx_843,BW_01025,4196260,140460,1061,4197321,0.99974721971467,415164
BW_25611,BW_25611_idx_291,BW_01025,9225273,322798,2374,9227647,0.999742729647114,1051257
TOWWC026,TOWWC026_idx_162,BW_01025,3667224,139518,34238,3701462,0.990750141430602,308954
BW_20719,BW_20719_idx_292,BW_01026,5317684,197536,1620,5319304,0.999695448878274,481938
BW_20720,BW_20720_idx_293,BW_01026,8078319,315471,2790,8081109,0.999654750356665,1006929
BW_20721,BW_20721_idx_844,BW_01026,1809386,65010,602,1809988,0.999667401109842,173747
BW_25613,BW_25613_idx_991,BW_01026,9474499,363121,2993,9477492,0.999684199153109,1201438
TOWWC027,TOWWC027_idx_170,BW_01026,274939,12074,3636,278575,0.986947859642825,35698
BW_20722,BW_20722_idx_294,BW_01027,11764030,553091,6836,11770866,0.999419244089602,1716014
BW_20722,BW_20722_idx_845,BW_01027,3534071,156398,1873,3535944,0.999470297040903,398506
BW_20723,BW_20723_idx_295,BW_01027,8845681,412498,4995,8850676,0.999435636328796,1223172
BW_20724,BW_20724_idx_296,BW_01027,4403691,205998,2713,4406404,0.999384305206695,629490
BW_20725,BW_20725_idx_297,BW_01027,13039055,613226,7585,13046640,0.999418624258813,1809418
BW_25615,BW_25615_idx_298,BW_01027,11815234,551745,6901,11822135,0.999416264490297,1634000
TOWWC028,TOWWC028_idx_178,BW_01027,2293336,110462,39848,2333184,0.982921192670617,193098
BW_20736,BW_20736_idx_299,BW_01030,13730867,496171,3586,13734453,0.999738904782011,1809179
BW_20737,BW_20737_idx_300,BW_01030,14993850,541126,3894,14997744,0.999740360950287,1949697
BW_20738,BW_20738_A_idx_846,BW_01030,6194438,220700,1611,6196049,0.999739995600422,770112
BW_20739,BW_20739_idx_301,BW_01030,10221068,366705,2627,10223695,0.99974304789022,1282260
BW_20740,BW_20740_idx_302,BW_01030,11003063,397883,2942,11006005,0.999732691380751,1450307
BW_20745,BW_20745_idx_306,BW_01032,15948819,598587,4647,15953466,0.999708715334962,2296836
BW_20746,BW_20746_idx_307,BW_01032,7668529,281931,2393,7670922,0.999688042715074,1035464
BW_20747,BW_20747_idx_308,BW_01032,11921671,444674,3478,11925149,0.999708347459642,1617247
BW_20748,BW_20748_idx_309,BW_01032,18934263,700803,5444,18939707,0.999712561551243,2669640
BW_20748,BW_20748_idx_848,BW_01032,4333759,157651,1268,4335027,0.9997074989383,495343
BW_20749,BW_20749_idx_310,BW_01033,15050432,561951,4493,15054925,0.999701559456457,2125348
BW_20751,BW_20751_idx_311,BW_01033,17255248,641068,5072,17260320,0.999706146815355,2409018
BW_20752,BW_20752_idx_312,BW_01033,11025923,405862,3261,11029184,0.999704329894215,1441597
BW_20752,BW_20752_idx_849,BW_01033,7189363,264595,2128,7191491,0.999704094741967,919486
BW_25621,BW_25621_idx_313,BW_01033,13099478,480665,3883,13103361,0.999703663815719,1776946
TOWWC034,TOWWC034_idx_99,BW_01033,3824217,125443,852,3825069,0.999777258920035,304448
BW_20776,BW_20776_idx_314,BW_01039,14524339,532491,4392,14528731,0.999697702435264,1877317
BW_20777,BW_20777_idx_315,BW_01039,12690777,457232,3799,12694576,0.999700738331079,1532365
BW_20777,BW_20777_idx_850,BW_01039,5939449,210788,1854,5941303,0.999687947239856,729967
NA,TA10081,BW_01039,229143,9892,169,229312,0.999263012838404,NA
TOWWC040,TOWWC040_idx_107,BW_01039,3887378,124674,847,3888225,0.99978216281208,304458
BW_20782,BW_20782_idx_316,BW_01041,12940448,605950,7255,12947703,0.999439668951319,1770362
BW_20783,BW_20783_idx_317,BW_01041,9900559,455457,5491,9906050,0.999445692278961,1470616
BW_20784,BW_20784_idx_318,BW_01041,13710698,645475,7471,13718169,0.999455393791985,1983515
BW_20785,BW_20785_idx_319,BW_01041,16481696,773949,9206,16490902,0.999441752791933,2440742
BW_20786,BW_20786_idx_320,BW_01041,11072430,519028,6465,11078895,0.999416458049291,1596198
BW_20786,BW_20786_idx_851,BW_01041,1364228,58707,674,1364902,0.99950619165332,144040
NA,TA10086,BW_01041,421114,21334,684,421798,0.998378370689287,NA
TOWWC042,TOWWC042_idx_115,BW_01041,2582048,108129,936,2582984,0.999637628417365,229283
BW_20787,BW_20787_idx_321,BW_01042,13169195,480262,3351,13172546,0.999745607265292,1942145
BW_20788,BW_20788_idx_322,BW_01042,11799099,427600,2930,11802029,0.999751737603763,1659462
BW_20789,BW_20789_idx_323,BW_01042,13903022,498594,3444,13906466,0.999752345419749,1900163
BW_20790,BW_20790_idx_324,BW_01042,13469444,484313,3252,13472696,0.9997586229215,1721309
BW_20790,BW_20790_idx_852,BW_01042,2820411,97046,605,2821016,0.999785538259974,323109
NA,TA10090,BW_01042,619330,25006,285,619615,0.999540036958434,NA
TOWWC043,TOWWC043_idx_123,BW_01042,3264452,103370,625,3265077,0.99980858031832,269305
BW_20793,BW_20793_idx_325,BW_01043,12111250,439529,2983,12114233,0.999753760720964,1610588
BW_20794,BW_20794_idx_326,BW_01043,12434937,448755,2925,12437862,0.999764830965322,1635257
BW_20794,BW_20794_idx_853,BW_01043,4666908,166226,1122,4668030,0.999759641647547,535715
NA,TA10091,BW_01043,402336,16344,187,402523,0.99953543027355,NA
TOWWC044,TOWWC044_idx_131,BW_01043,2644448,84207,563,2645011,0.999787146442869,209232
BW_20795,BW_20795_idx_327,BW_01044,10962606,390864,2619,10965225,0.999761154011888,1403001
BW_20795,BW_20795_idx_854,BW_01044,5066908,178085,1262,5068170,0.999750994935055,636819
BW_25647,BW_25647_idx_992,BW_01044,11167084,390466,2531,11169615,0.999773403111925,1424636
NA,TA10093,BW_01044,571207,22411,270,571477,0.999527540040982,NA
TOWWC045,TOWWC045_idx_139,BW_01044,1774782,55153,331,1775113,0.999813532997618,135137
BW_20799,BW_20799_idx_328,BW_01045,7449180,265985,2034,7451214,0.999727024347979,973380
BW_20800,BW_20800_idx_329,BW_01045,10624176,375002,2623,10626799,0.999753171204236,1560578
BW_20801,BW_20801_idx_330,BW_01045,11315945,400840,2879,11318824,0.999745644953928,1546566
BW_20801,BW_20801_idx_855,BW_01045,1821409,62491,561,1821970,0.999692091527303,195199
NA,TA10094,BW_01045,576320,22545,250,576570,0.999566401304265,NA
TOWWC046,TOWWC046_idx_147,BW_01045,2345124,73113,465,2345589,0.999801755550525,178114
BW_20802,BW_20802_idx_331,BW_01046,10368390,362887,2308,10370698,0.999777449888137,1291709
BW_20803,BW_20803_idx_332,BW_01046,8932818,308851,2042,8934860,0.999771456967429,1033365
BW_20804,BW_20804_idx_333,BW_01046,12324952,432668,2804,12327756,0.999772545790167,1430922
BW_20805,BW_20805_idx_334,BW_01046,13222690,466419,2962,13225652,0.999776041287038,1659714
BW_20806,BW_20806_idx_335,BW_01046,12344714,434545,2683,12347397,0.999782707237809,1563730
BW_20807,BW_20807_A_idx_856,BW_01046,7323649,253393,1804,7325453,0.999753735366263,873540
BW_20807,BW_20807_B_idx_857,BW_01046,7711408,264497,1808,7713216,0.999765597125764,942337
BW_20807,BW_20807_C_idx_858,BW_01046,9576525,331362,2158,9578683,0.999774708067905,1151934
NA,TA10095,BW_01046,1416919,53451,633,1417552,0.999553455534612,NA
TOWWC047,TOWWC047_idx_155,BW_01046,2004919,62695,417,2005336,0.999792054797799,155418
BW_20808,BW_20808_idx_336,BW_01047,12307501,574438,6659,12314160,0.99945924041916,1638464
BW_20809,BW_20809_idx_337,BW_01047,9000066,416400,5055,9005121,0.999438652739924,1247699
BW_20810,BW_20810_idx_338,BW_01047,9634495,447081,5559,9640054,0.999423343479196,1308161
BW_20811,BW_20811_idx_339,BW_01047,5171978,235261,2881,5174859,0.999443269855275,659711
BW_20812,BW_20812_idx_340,BW_01047,7429916,340273,4106,7434022,0.999447674488991,960296
BW_20813,BW_20813_idx_341,BW_01047,5770014,264317,3132,5773146,0.999457488170228,760137
BW_20814,BW_20814_idx_342,BW_01047,9906540,457627,5283,9911823,0.999467000167376,1345983
BW_20814,BW_20814_idx_859,BW_01047,684109,27983,332,684441,0.999514932623849,59759
NA,TA10098,BW_01047,226496,11049,352,226848,0.998448300183383,NA
TOWWC048,TOWWC048_idx_163,BW_01047,2803947,113426,998,2804945,0.999644199797144,238700
BW_25649,BW_25649_idx_346,BW_01049,9841909,342837,2904,9844813,0.999705022330033,1212279
BW_25649,BW_25649_idx_880,BW_01049,4633744,162063,1376,4635120,0.999703136056887,534207
BW_25651,BW_25651_idx_347,BW_01049,8286684,291505,2504,8289188,0.99969791974799,1045415
NA,TA10124,BW_01049,1603099,59843,1188,1604287,0.999259484119737,NA
TOWWC050,TOWWC050_idx_179,BW_01049,1174719,36548,281,1175000,0.99976085106383,86773
BW_20822,BW_20822_idx_348,BW_01050,12008136,553497,6447,12014583,0.999463402100597,1644574
BW_20823,BW_20823_idx_349,BW_01050,11546146,534889,6162,11552308,0.999466600094111,1657092
BW_20824,BW_20824_idx_350,BW_01050,9671598,450345,5362,9676960,0.999445900365404,1371839
BW_20825,BW_20825_idx_351,BW_01050,11976060,557828,6590,11982650,0.999450038180202,1705182
BW_20826,BW_20826_idx_1001,BW_01050,7980880,369063,4375,7985255,0.999452115179791,1165433
NA,TA10142,BW_01050,835274,40314,1442,836716,0.998276595642966,NA
TOWWC051,TOWWC051_idx_187,BW_01050,549421,21559,235,549656,0.999572459865807,45808
NA,TA10171,BW_01051,262206,40666,2928,265134,0.988956527642626,NA
BW_20854,BW_20854_idx_352,BW_01055,13074157,559235,5504,13079661,0.999579193986755,1730251
BW_20855,BW_20855_idx_353,BW_01055,14460885,616947,6258,14467143,0.999567433597636,2103683
BW_20855,BW_20855_idx_788,BW_01055,3598710,150318,1516,3600226,0.999578915323649,480016
BW_20856,BW_20856_idx_354,BW_01055,12775131,542279,5615,12780746,0.999560667272474,1730887
BW_25656,BW_25656_idx_355,BW_01055,13014417,548909,5374,13019791,0.999587243758368,1703883
BW_25658,BW_25658_idx_993,BW_01055,8385394,351288,3556,8388950,0.999576109048212,1102841
NA,TA10417,BW_01055,1069729,47399,1473,1071202,0.998624909214135,NA
TOWWC056,TOWWC056_idx_100,BW_01055,2904287,108430,844,2905131,0.9997094795381,245387
TOWWC056,TOWWC056_idx_188,BW_01055,1253313,58550,17582,1270895,0.986165654912483,101492
BW_20857,BW_20857_idx_356,BW_01056,12685662,445141,2787,12688449,0.999780351404652,1617356
BW_20858,BW_20858_idx_357,BW_01056,10018633,346454,2146,10020779,0.99978584499269,1258065
BW_20860,BW_20860_idx_358,BW_01056,15357421,536910,3166,15360587,0.999793888085136,2056229
BW_25673,BW_25673_idx_359,BW_01056,8230482,279568,1863,8232345,0.999773697530898,793865
NA,TA10919,BW_01056,1162141,44388,448,1162589,0.999614653157737,NA
TOWWC057,TOWWC057_idx_108,BW_01056,2263694,68595,404,2264098,0.999821562494203,163600
BW_20862,BW_20862_idx_360,BW_01057,13775583,484290,3117,13778700,0.999773781271092,1872350
BW_20863,BW_20863_idx_361,BW_01057,9202850,325446,2105,9204955,0.999771318816876,1261115
BW_20864,BW_20864_idx_362,BW_01057,7405256,258192,1556,7406812,0.99978992311402,908494
BW_20864,BW_20864_idx_789,BW_01057,10110931,363953,2507,10113438,0.999752111991985,1531446
BW_25676,BW_25676_idx_363,BW_01057,13523645,465682,2836,13526481,0.999790337191173,1639243
NA,TA10921,BW_01057,755612,29256,284,755896,0.999624286938944,NA
TOWWC058,TOWWC058_idx_116,BW_01057,3493569,109718,637,3494206,0.999817698212412,272333
BW_20865,BW_20865_A_idx_790,BW_01058,7490822,259076,1814,7492636,0.999757895619112,926757
BW_20867,BW_20867_idx_364,BW_01058,13425820,473868,3131,13428951,0.999766847015824,1668913
BW_20868,BW_20868_idx_365,BW_01058,12260421,433296,2973,12263394,0.99975757119114,1603646
BW_25682,BW_25682_idx_366,BW_01058,8433163,298783,2100,8435263,0.999751045106715,1045890
NA,TA10930,BW_01058,1322209,55615,7201,1329410,0.994583311393776,NA
TOWWC059,TOWWC059_idx_124,BW_01058,4169213,132283,824,4170037,0.999802399834822,327887
BW_20869,BW_20869_idx_367,BW_01059,10762086,375671,2542,10764628,0.999763856215003,1230593
BW_20870,BW_20870_idx_368,BW_01059,9810088,380697,54595,9864683,0.994465610298881,1427464
BW_20871,BW_20871_idx_369,BW_01059,12346416,431387,2921,12349337,0.999763469083401,1681494
BW_20872,BW_20872_idx_791,BW_01059,9553443,332786,2104,9555547,0.999779813756345,1167489
BW_25686,BW_25686_idx_994,BW_01059,5394822,184212,1337,5396159,0.999752231170356,623112
NA,TA10931,BW_01059,1088022,44155,3867,1091889,0.996458431214162,NA
TOWWC060,TOWWC060_idx_132,BW_01059,3771678,119554,772,3772450,0.999795358454055,328873
BW_20873,BW_20873_idx_370,BW_01060,11513900,410537,2969,11516869,0.999742204239711,1641512
BW_20874,BW_20874_idx_371,BW_01060,8393019,300188,2290,8395309,0.999727228622556,1133995
BW_20875,BW_20875_idx_372,BW_01060,9563307,338521,2499,9565806,0.999738756985036,1261508
BW_20876,BW_20876_idx_1002,BW_01060,11393519,404561,2693,11396212,0.999763693409705,1490213
BW_20876,BW_20876_idx_373,BW_01060,12712873,450014,3055,12715928,0.999759750133848,1707637
BW_25688,BW_25688_idx_374,BW_01060,7932249,282980,2111,7934360,0.999733941994061,1033321
NA,TA10933,BW_01060,796932,30530,383,797315,0.999519637784314,NA
TOWWC061,TOWWC061_idx_140,BW_01060,2505665,78840,498,2506163,0.999801289860237,195093
BW_20880,BW_20880_idx_375,BW_01062,9747809,351657,2313,9750122,0.999762772199158,1355891
BW_20881,BW_20881_idx_376,BW_01062,9050496,318504,2208,9052704,0.999756094974496,1179278
BW_20882,BW_20882_idx_377,BW_01062,13842261,496041,3565,13845826,0.999742521681263,2207019
BW_20883,BW_20883_idx_378,BW_01062,14000089,493293,3397,14003486,0.999757417545888,1913208
BW_20883,BW_20883_idx_792,BW_01062,9199853,315818,2227,9202080,0.999757989498027,1032197
NA,TA10935,BW_01062,757490,29252,429,757919,0.999433976453948,NA
TOWWC063,TOWWC063_idx_148,BW_01062,2414298,74082,454,2414752,0.999811988974437,191822
BW_20884,BW_20884_idx_379,BW_01063,9967524,351784,2615,9970139,0.999737716796125,1255543
BW_20885,BW_20885_idx_380,BW_01063,14082198,501701,3395,14085593,0.99975897358386,1933627
BW_20886,BW_20886_idx_381,BW_01063,16875668,602998,4368,16880036,0.999741232779361,2348622
BW_20887,BW_20887_idx_382,BW_01063,11030974,391141,2844,11033818,0.999742246971991,1439345
BW_20888,BW_20888_idx_383,BW_01063,11131416,406116,2876,11134292,0.999741698888443,1801893
BW_20889,BW_20889_idx_384,BW_01063,10744000,386541,2813,10746813,0.999738247981053,1563711
NA,TA10936,BW_01063,1028438,41616,3495,1031933,0.996613152210463,NA
TOWWC064,TOWWC064_idx_156,BW_01063,1940222,60560,422,1940644,0.999782546412428,150020
BW_20896,BW_20896_idx_481,BW_01065,10270616,370612,2718,10273334,0.999735431555131,1476764
BW_20897,BW_20897_idx_793,BW_01065,5119770,180649,1473,5121243,0.999712374515328,621490
BW_25694,BW_25694_idx_995,BW_01065,7451984,258792,1849,7453833,0.999751939706725,909157
NA,TA10939,BW_01065,827741,32270,428,828169,0.999483197270122,NA
TOWWC066,TOWWC066_idx_164,BW_01065,2737774,86085,512,2738286,0.999813021722347,211146
BW_20899,BW_20899_idx_482,BW_01066,10884870,390982,2837,10887707,0.999739430901291,1484381
BW_20900,BW_20900_idx_483,BW_01066,10746074,388315,2849,10748923,0.999734950189893,1460642
BW_20901,BW_20901_idx_484,BW_01066,7472029,266421,2090,7474119,0.999720368380541,949731
BW_25702,BW_25702_idx_485,BW_01066,10636069,383851,2802,10638871,0.999736626189001,1424837
BW_25704,BW_25704_idx_996,BW_01066,4736770,162912,1172,4737942,0.999752635215881,521332
NA,TA10940,BW_01066,1151653,44145,640,1152293,0.99944458570867,NA
TOWWC067,TOWWC067_idx_172,BW_01066,1218907,38200,283,1219190,0.999767878673546,91219
BW_20905,BW_20905_idx_486,BW_01068,11629567,420332,2837,11632404,0.999756112322096,1688136
BW_20906,BW_20906_idx_487,BW_01068,9876264,356855,2503,9878767,0.999746628298856,1428502
BW_20907,BW_20907_idx_488,BW_01068,9455149,345461,2522,9457671,0.999733338154816,1400869
BW_20908,BW_20908_idx_489,BW_01068,12627821,454139,3147,12630968,0.999750850449467,1773646
BW_20909,BW_20909_idx_490,BW_01068,11678071,418071,2821,11680892,0.999758494471141,1588326
BW_20910,BW_20910_idx_491,BW_01068,12970566,461835,3191,12973757,0.999754041947911,1746129
BW_20910,BW_20910_idx_794,BW_01068,10871662,380876,2670,10874332,0.999754467676727,1474208
NA,TA10942,BW_01068,799126,33299,2987,802113,0.996276085788411,NA
TOWWC069,TOWWC069_idx_180,BW_01068,849618,26593,201,849819,0.999763479046715,67902
BW_20912,BW_20912_idx_492,BW_01069,7972064,272205,2295,7974359,0.999712202573273,995683
BW_20913,BW_20913_idx_493,BW_01069,10093160,357233,2895,10096055,0.999713254335481,1414948
BW_20914,BW_20914_idx_494,BW_01069,13472037,472107,3548,13475585,0.999736709018569,1927010
BW_20914,BW_20914_idx_795,BW_01069,8757822,297931,2483,8760305,0.999716562379963,1063982
NA,TA10943,BW_01069,1011568,42301,4865,1016433,0.995213654023433,NA
BW_20915,BW_20915_idx_495,BW_01070,14002262,555127,63789,14066051,0.995465038481661,2070756
BW_20916,BW_20916_idx_496,BW_01070,15216790,608974,69420,15286210,0.99545865194839,2285787
BW_20917,BW_20917_idx_497,BW_01070,11577692,460870,52562,11630254,0.995480580217767,1809608
BW_20918,BW_20918_idx_498,BW_01070,14532263,568902,65408,14597671,0.995519285233925,2034566
BW_20919,BW_20919_idx_499,BW_01070,8261274,322754,36552,8297826,0.995594990784333,1087405
BW_20919,BW_20919_idx_796,BW_01070,4912585,193800,21960,4934545,0.995549741668178,738014
NA,TA10944,BW_01070,1022725,42032,2549,1025274,0.997513835325971,NA
TOWWC071,TOWWC071_idx_101,BW_01070,4004670,144047,17702,4022372,0.995599114154534,346429
BW_20920,BW_20920_idx_500,BW_01071,6586375,234543,1722,6588097,0.999738619513344,888528
BW_20921,BW_20921_idx_501,BW_01071,14224206,515300,3593,14227799,0.999747466210339,1953480
BW_20922,BW_20922_idx_502,BW_01071,15374461,568204,3917,15378378,0.999745291733628,2292544
BW_20923,BW_20923_idx_503,BW_01071,14861948,537040,3707,14865655,0.999750633254976,2029404
BW_25707,BW_25707_idx_997,BW_01071,1849829,61965,468,1850297,0.999747067632926,177160
NA,TA10945,BW_01071,706737,32280,7663,714400,0.989273516237402,NA
TOWWC072,TOWWC072_idx_109,BW_01071,3489353,116176,1050,3490403,0.999699175138229,295204
BW_20924,BW_20924_A_idx_797,BW_01072,6162019,219754,1662,6163681,0.999730355935033,893273
BW_20925,BW_20925_idx_504,BW_01072,14038869,508521,3493,14042362,0.999751252673874,2117522
BW_20926,BW_20926_idx_505,BW_01072,12948931,469038,3233,12952164,0.999750389201372,1997241
BW_20927,BW_20927_idx_506,BW_01072,14810741,533667,3548,14814289,0.999760501499599,2197428
BW_20928,BW_20928_idx_507,BW_01072,12490781,442359,2929,12493710,0.999765562030814,1686948
NA,TA10946,BW_01072,736008,29978,1392,737400,0.998112286411717,NA
TOWWC073,TOWWC073_idx_117,BW_01072,5054661,163252,1059,5055720,0.999790534285918,418843
BW_20929,BW_20929_idx_508,BW_01073,6911000,244298,1888,6912888,0.999726886939294,894859
BW_20930,BW_20930_idx_509,BW_01073,11542107,414549,2920,11545027,0.999747077248065,1678872
BW_20931,BW_20931_idx_510,BW_01073,11759685,418295,2946,11762631,0.99974954582865,1576605
BW_20932,BW_20932_idx_511,BW_01073,15131693,538395,3597,15135290,0.999762343503164,2093341
BW_25709,BW_25709_idx_512,BW_01073,15212458,543204,3723,15216181,0.999755326254334,2087288
NA,TA10947,BW_01073,700979,29703,2962,703941,0.995792260999146,NA
TOWWC074,TOWWC074_idx_125,BW_01073,2313405,73001,471,2313876,0.999796445444786,188891
BW_20934,BW_20934_idx_513,BW_01074,15435504,557917,3659,15439163,0.999763005287268,2226163
BW_20935,BW_20935_idx_514,BW_01074,12406350,487247,70317,12476667,0.994364119840659,1894347
BW_20936,BW_20936_idx_515,BW_01074,15175879,543052,3743,15179622,0.999753419419798,2033139
BW_20937,BW_20937_idx_516,BW_01074,10100944,390338,56481,10157425,0.994439437160501,1390741
BW_20938,BW_20938_idx_799,BW_01074,9377732,359765,52571,9430303,0.994425311678745,1300836
NA,TA10948,BW_01074,748713,33705,7943,756656,0.98950249518936,NA
TOWWC075,TOWWC075_idx_133,BW_01074,2294893,73887,483,2295376,0.999789576958198,183602
BW_20944,BW_20944_idx_517,BW_01076,7948221,286791,1925,7950146,0.999757866081956,1027926
BW_20945,BW_20945_idx_518,BW_01076,10132347,368444,2550,10134897,0.999748394088268,1332866
BW_20946,BW_20946_idx_519,BW_01076,16296821,589831,4043,16300864,0.99975197633696,2254227
BW_20946,BW_20946_idx_800,BW_01076,12774799,456057,3208,12778007,0.999748943634168,1619009
NA,TA10950,BW_01076,915349,39556,5602,920951,0.993917157373194,NA
TOWWC077,TOWWC077_idx_141,BW_01076,1258115,38695,243,1258358,0.999806891202663,168198
BW_20948,BW_20948_idx_520,BW_01077,7971716,304238,18506,7990222,0.997683919170206,1208851
BW_20949,BW_20949_idx_521,BW_01077,11971427,451460,27974,11999401,0.997668716963455,1734345
BW_20950,BW_20950_idx_1003,BW_01077,6484119,239033,14524,6498643,0.997765071877313,812086
BW_20950,BW_20950_idx_522,BW_01077,14265534,536669,32672,14298206,0.99771495808635,2132388
BW_20950,BW_20950_idx_801,BW_01077,7679841,279840,17643,7697484,0.997707952364695,1097454
BW_25711,BW_25711_idx_523,BW_01077,12400456,467204,28679,12429135,0.997692598881579,1752702
NA,TA10951,BW_01077,550151,23148,1965,552116,0.996440965304393,NA
TOWWC078,TOWWC078_idx_149,BW_01077,1815508,60383,4034,1819542,0.997782958568695,146234
BW_20951,BW_20951_A_idx_802,BW_01078,6582845,231019,1735,6584580,0.999736505593371,1023205
BW_20952,BW_20952_idx_524,BW_01078,6635711,230932,1600,6637311,0.999758938521941,781433
BW_20953,BW_20953_idx_525,BW_01078,5623625,186427,1323,5624948,0.999764797825687,1343731
BW_20954,BW_20954_idx_526,BW_01078,15670129,553819,3627,15673756,0.999768594075345,2221304
NA,TA10952,BW_01078,609738,23628,238,609976,0.999609820714258,NA
TOWWC079,TOWWC079_idx_157,BW_01078,2649072,86950,561,2649633,0.99978827256454,250359
BW_20955,BW_20955_idx_527,BW_01079,14444406,686350,7860,14452266,0.999456140649501,2217199
BW_20956,BW_20956_idx_528,BW_01079,10937686,518935,6122,10943808,0.999440596911057,1554526
BW_20958,BW_20958_idx_529,BW_01079,10878068,513682,6029,10884097,0.99944607255889,1483270
BW_20959,BW_20959_idx_530,BW_01079,13984426,664819,7856,13992282,0.999438547622182,2059410
BW_20960,BW_20960_idx_531,BW_01079,10757119,508740,6013,10763132,0.999441333619248,1517730
BW_20961,BW_20961_idx_532,BW_01079,6056331,282407,3289,6059620,0.999457226690783,823779
BW_20962,BW_20962_idx_533,BW_01079,9161043,435306,5055,9166098,0.999448511242188,1327144
BW_20963,BW_20963_idx_534,BW_01079,9657535,457456,5285,9662820,0.999453058216959,1386348
BW_20963,BW_20963_idx_803,BW_01079,5521388,250761,2665,5524053,0.999517564368046,665435
NA,TA1581,BW_01079,2307265,166001,19463,2326728,0.991635034262707,NA
TOWWC080,TOWWC080_idx_165,BW_01079,2390939,101321,932,2391871,0.999610346879075,215985
BW_20968,BW_20968_idx_535,BW_01081,12033860,441847,3129,12036989,0.999740051270297,1597184
BW_20969,BW_20969_idx_536,BW_01081,11886184,438988,3140,11889324,0.999735897516125,1661966
BW_20970,BW_20970_idx_537,BW_01081,14104785,523502,3801,14108586,0.999730589585661,2041134
BW_20971,BW_20971_idx_538,BW_01081,13548724,496666,3625,13552349,0.99973251869473,1869886
BW_20972,BW_20972_idx_539,BW_01081,13961692,515097,3815,13965507,0.999726826960167,1935720
BW_20973,BW_20973_idx_540,BW_01081,11674726,428191,3041,11677767,0.999739590625502,1523781
BW_20974,BW_20974_idx_541,BW_01081,10439905,385532,2556,10442461,0.999755230112902,1422198
BW_20975,BW_20975_idx_542,BW_01081,11966007,437203,2852,11968859,0.999761714963807,1587951
BW_20975,BW_20975_idx_804,BW_01081,1248350,42113,433,1248783,0.999653262416288,127119
NA,TA1585,BW_01081,905894,29916,390,906284,0.999569671317159,NA
TOWWC082,TOWWC082_idx_173,BW_01081,2552072,84273,562,2552634,0.999779835260362,198949
BW_25712,BW_25712_idx_543,BW_01082,11127760,403525,3401,11131161,0.999694461341454,2048191
BW_25712,BW_25712_idx_805,BW_01082,3770909,132242,1096,3772005,0.999709438349101,472229
BW_25713,BW_25713_idx_544,BW_01082,15477564,549437,4358,15481922,0.999718510402003,2289583
NA,TA1586,BW_01082,652089,21994,304,652393,0.999534023203805,NA
TOWWC083,TOWWC083_idx_181,BW_01082,2200969,68759,554,2201523,0.999748356024443,168323
BW_20984,BW_20984_idx_549,BW_01084,13436358,590751,5801,13442159,0.999568447300765,1883658
BW_20985,BW_20985_idx_550,BW_01084,11965624,529399,5338,11970962,0.999554087633057,1767303
BW_20986,BW_20986_idx_551,BW_01084,12371836,535689,5395,12377231,0.999564118985902,1766570
BW_20987,BW_20987_idx_552,BW_01084,13245205,581242,6195,13251400,0.99953250222618,1908090
BW_20988,BW_20988_idx_553,BW_01084,4647539,203316,2096,4649635,0.999549211927388,562789
BW_20989,BW_20989_idx_554,BW_01084,7521964,328236,3463,7525427,0.999539826776607,1088734
NA,TA1600,BW_01084,641434,21283,620,642054,0.999034349135743,NA
TOWWC085,TOWWC085_idx_102,BW_01084,4082669,162086,1392,4084061,0.9996591627794,423243
BW_20990,BW_20990_idx_555,BW_01085,10095031,439699,5118,10100149,0.999493274802184,1316650
BW_20990,BW_20990_idx_809,BW_01085,7124042,303773,3403,7127445,0.999522549805716,1078456
BW_20991,BW_20991_idx_556,BW_01085,7881500,337843,3692,7885192,0.999531780583149,1035612
BW_20992,BW_20992_idx_557,BW_01085,10152078,445146,5061,10157139,0.999501729768589,1376223
BW_20993,BW_20993_idx_558,BW_01085,11129623,491301,5544,11135167,0.999502117929619,1610867
BW_25716,BW_25716_idx_559,BW_01085,5577729,240809,3042,5580771,0.99945491402532,765526
BW_25718,BW_25718_idx_961,BW_01085,6188775,265988,3137,6191912,0.999493371352823,802247
NA,TA1605,BW_01085,1648837,70270,2596,1651433,0.998428031897146,NA
TOWWC086,TOWWC086_idx_110,BW_01085,2551998,97994,892,2552890,0.999650592074081,231872
BW_24567,BW_24567_idx_560,BW_01086,10283125,403334,3282,10286407,0.999680938154596,1663216
BW_24568,BW_24568_idx_561,BW_01086,9186152,356934,2827,9188979,0.999692348845285,1275861
BW_24569,BW_24569_idx_810,BW_01086,5421310,209343,1784,5423094,0.999671036496878,758357
NA,TA1606,BW_01086,354055,12411,170,354225,0.999520079045804,NA
TOWWC087,TOWWC087_idx_118,BW_01086,2296026,78760,533,2296559,0.999767913648202,193279
BW_20996,BW_20996_idx_562,BW_01087,11629961,441551,3482,11633443,0.999700690500654,1722692
BW_20997,BW_20997_A_idx_811,BW_01087,3793742,135839,1011,3794753,0.999733579497796,425931
BW_20997,BW_20997_idx_563,BW_01087,7059095,266004,2093,7061188,0.999703590953817,943293
BW_25745,BW_25745_idx_564,BW_01087,10982766,414089,3424,10986190,0.999688335992733,1481599
BW_25747,BW_25747_idx_963,BW_01087,8398959,312614,2358,8401317,0.999719329719376,1097109
NA,TA1612,BW_01087,688664,23328,324,688988,0.999529745075386,NA
TOWWC088,TOWWC088_idx_126,BW_01087,3277897,119690,1328,3279225,0.999595026263828,365447
BW_20998,BW_20998_A_idx_812,BW_01088,6954790,297846,3048,6957838,0.999561932887774,890472
BW_20999,BW_20999_idx_565,BW_01088,13242988,589287,6239,13249227,0.999529104603612,2085051
BW_21001,BW_21001_idx_566,BW_01088,10560416,469950,5055,10565471,0.999521554694533,1600141
BW_21002,BW_21002_idx_567,BW_01088,11744399,522485,5753,11750152,0.999510389312411,1716452
NA,TA1613,BW_01088,627869,21104,614,628483,0.999023044378289,NA
TOWWC089,TOWWC089_idx_134,BW_01088,2902134,141018,44751,2946885,0.98481413424684,276747
BW_21004,BW_21004_idx_568,BW_01089,12147241,459068,8505,12155746,0.999300330888783,1920138
BW_21005,BW_21005_idx_569,BW_01089,12238690,453348,3652,12242342,0.999701691065321,2228099
BW_21006,BW_21006_idx_570,BW_01089,13105792,483704,3611,13109403,0.999724548860082,1886071
BW_25748,BW_25748_idx_571,BW_01089,12131881,442651,3223,12135104,0.99973440689095,1590062
NA,TA1615,BW_01089,1129348,42482,765,1130113,0.999323076541903,NA
TOWWC090,TOWWC090_idx_142,BW_01089,1816382,59041,401,1816783,0.999779280189214,163965
BW_21012,BW_21012_idx_572,BW_01091,15602200,556318,3614,15605814,0.999768419641551,2088421
BW_21013,BW_21013_idx_573,BW_01091,10341590,368885,2474,10344064,0.999760829012659,1577809
BW_21013,BW_21013_idx_813,BW_01091,4649300,162224,1180,4650480,0.999746262751372,600044
NA,TA1622,BW_01091,517902,17771,175,518077,0.999662212373836,NA
TOWWC092,TOWWC092_idx_150,BW_01091,2509072,79247,548,2509620,0.999781640248324,196681
BW_21028,BW_21028_idx_574,BW_01094,11636294,513113,5355,11641649,0.999540013618346,1738271
BW_21029,BW_21029_idx_575,BW_01094,13381785,585213,6259,13388044,0.999532493320159,1966732
BW_21030,BW_21030_idx_576,BW_01094,12232033,548015,15286,12247319,0.998751890107541,2007955
BW_21031,BW_21031_idx_673,BW_01094,10186725,445711,4675,10191400,0.999541279902663,1508615
BW_21032,BW_21032_idx_674,BW_01094,9940030,432869,4940,9944970,0.999503266475414,1467722
BW_21033,BW_21033_idx_675,BW_01094,11142006,482061,5210,11147216,0.999532618727402,1597726
BW_21033,BW_21033_idx_814,BW_01094,7175533,303145,3026,7178559,0.999578466931873,895155
NA,TA1641,BW_01094,498389,16765,490,498879,0.999017797902898,NA
TOWWC095,TOWWC095_idx_158,BW_01094,1441063,53649,427,1441490,0.999703778728954,125547
BW_21034,BW_21034_idx_676,BW_01095,11232541,489153,5503,11238044,0.999510324038596,1627881
BW_21035,BW_21035_idx_677,BW_01095,8497684,368324,4273,8501957,0.999497409831642,1201547
BW_21036,BW_21036_idx_678,BW_01095,11851278,518153,5801,11857079,0.999510756401302,1778608
BW_21037,BW_21037_idx_679,BW_01095,2434333,94767,795,2435128,0.999673528455178,267424
NA,TA1642,BW_01095,523071,18133,516,523587,0.999014490428525,NA
TOWWC096,TOWWC096_idx_166,BW_01095,3274718,129564,1163,3275881,0.999644980999005,310888
BW_21038,BW_21038_idx_680,BW_01096,10277091,388126,3253,10280344,0.999683570899962,1552268
BW_21039,BW_21039_idx_681,BW_01096,12482037,471042,3962,12485999,0.999682684581346,1816965
BW_21040,BW_21040_idx_682,BW_01096,10944877,409816,3317,10948194,0.999697027655886,1538480
BW_21041,BW_21041_idx_683,BW_01096,11929757,442417,3623,11933380,0.999696397835316,1611876
BW_21042,BW_21042_idx_684,BW_01096,11214627,416445,3380,11218007,0.999698698708246,1524537
BW_21043,BW_21043_idx_685,BW_01096,11234369,420228,3367,11237736,0.999700384490257,1553541
BW_21044,BW_21044_idx_686,BW_01096,12264169,459558,3787,12267956,0.999691309619956,1709781
BW_21045,BW_21045_idx_815,BW_01096,6242606,225886,1787,6244393,0.999713823265128,688925
NA,TA1643,BW_01096,671284,22066,319,671603,0.999525017011538,NA
TOWWC097,TOWWC097_idx_174,BW_01096,2090314,69401,457,2090771,0.999781420346848,167452
BW_21046,BW_21046_idx_687,BW_01097,8564245,393428,4674,8568919,0.99945454029849,1541517
BW_21047,BW_21047_idx_688,BW_01097,12795340,570186,6268,12801608,0.999510374009265,1899641
BW_21047,BW_21047_idx_816,BW_01097,6317347,277594,3006,6320353,0.999524393653329,762231
BW_21048,BW_21048_idx_689,BW_01097,12231713,547062,6187,12237900,0.999494439405454,1866918
BW_25752,BW_25752_idx_964,BW_01097,6247979,269103,2785,6250764,0.999554454463486,787462
NA,TA1644,BW_01097,448808,15743,502,449310,0.998882731299103,NA
TOWWC098,TOWWC098_idx_182,BW_01097,799469,29230,242,799711,0.999697390682384,124207
BW_21050,BW_21050_A_idx_817,BW_01098,8740854,377214,4294,8745148,0.999508984867952,1196651
BW_21050,BW_21050_idx_690,BW_01098,13354592,673250,104401,13458993,0.992243030366388,1998891
BW_21052,BW_21052_idx_691,BW_01098,6571733,281620,3306,6575039,0.999497189294238,876282
BW_21053,BW_21053_idx_692,BW_01098,5403228,230756,2883,5406111,0.999466714612408,704980
BW_25760,BW_25760_idx_693,BW_01098,10205551,444448,5294,10210845,0.99948153164601,1435840
BW_25762,BW_25762_idx_965,BW_01098,5252761,226211,2551,5255312,0.999514586384215,691384
NA,TA1645,BW_01098,429502,19721,691,430193,0.998393744203183,NA
TOWWC099,TOWWC099_idx_190,BW_01098,1589811,59728,515,1590326,0.999676167024874,137980
BW_21055,BW_21055_idx_694,BW_01099,11424900,549821,5250,11430150,0.999540688442409,1742603
BW_21056,BW_21056_idx_695,BW_01099,12799121,609618,5862,12804983,0.999542209466424,1907194
BW_21057,BW_21057_idx_696,BW_01099,11914641,572139,5426,11920067,0.999544801216302,1838981
BW_21058,BW_21058_idx_697,BW_01099,13189322,638538,6072,13195394,0.99953983943185,2142922
BW_21059,BW_21059_A_idx_818,BW_01099,11572590,553583,5180,11577770,0.999552590870263,1701794
BW_21059,BW_21059_idx_698,BW_01099,11566052,555838,5265,11571317,0.999544995612859,1754539
NA,TA1649,BW_01099,706150,27041,824,706974,0.998834469160111,NA
TOWWC100,TOWWC100_idx_103,BW_01099,2834628,119155,826,2835454,0.999708688626231,265643
BW_21061,BW_21061_idx_699,BW_01100,11154072,550110,77181,11231253,0.993128015191181,1601980
BW_21062,BW_21062_idx_700,BW_01100,8246897,405054,56470,8303367,0.99319914439528,1127051
BW_21063,BW_21063_idx_701,BW_01100,7460805,366738,50850,7511655,0.993230519772274,1084971
BW_25765,BW_25765_idx_702,BW_01100,11284728,559839,78334,11363062,0.993106259562783,1702059
NA,TA1651,BW_01100,1237322,55441,1908,1239230,0.99846033423981,NA
TOWWC101,TOWWC101_idx_111,BW_01100,2781412,121045,18732,2800144,0.993310344039449,275352
NA,TA1653,BW_01101,496379,72187,73800,570179,0.87056696230482,NA
BW_21069,BW_21069_idx_703,BW_01102,16199474,587420,4100,16203574,0.99974696940317,2294670
BW_21070,BW_21070_idx_704,BW_01102,15859738,574573,4202,15863940,0.999735122548371,2237540
BW_21071,BW_21071_idx_705,BW_01102,16355859,591698,4430,16360289,0.999729222387208,2331099
BW_21072,BW_21072_idx_706,BW_01102,10088430,361919,2753,10091183,0.99972718758544,1387618
BW_21073,BW_21073_idx_707,BW_01102,9873253,350622,2547,9875800,0.999742096842787,1266398
BW_21073,BW_21073_idx_819,BW_01102,3720911,126961,904,3721815,0.999757107755222,347885
NA,TA1656,BW_01102,952902,31936,358,953260,0.999624446635755,NA
TOWWC103,TOWWC103_idx_119,BW_01102,2232050,70535,454,2232504,0.999796640901875,202718
BW_21074,BW_21074_idx_708,BW_01103,13888612,487233,3178,13891790,0.999771231785105,1816099
BW_21075,BW_21075_idx_709,BW_01103,6190994,218446,1524,6192518,0.999753896557103,793327
BW_21076,BW_21076_idx_710,BW_01103,10440495,370721,2366,10442861,0.999773433736215,1409420
BW_21077,BW_21077_A_idx_820,BW_01103,6624350,230151,1582,6625932,0.999761241135587,843798
BW_21077,BW_21077_idx_711,BW_01103,19990846,715656,4415,19995261,0.999779197680891,3002421
BW_26837,BW_26837_idx_712,BW_01103,7312209,259646,1774,7313983,0.999757450899189,969638
NA,TA1658,BW_01103,469111,16374,148,469259,0.99968460913909,NA
TOWWC104,TOWWC104_idx_127,BW_01103,2856750,89431,557,2857307,0.999805061199234,241397
BW_21079,BW_21079_idx_713,BW_01104,14167861,521854,4027,14171888,0.999715845905641,2106781
BW_21080,BW_21080_idx_714,BW_01104,8152726,295182,2264,8154990,0.999722378568214,1071703
BW_21081,BW_21081_idx_715,BW_01104,7089455,255769,1964,7091419,0.999723045556891,930071
BW_21082,BW_21082_idx_716,BW_01104,6471008,234757,1778,6472786,0.999725311481022,799506
BW_21083,BW_21083_idx_717,BW_01104,10898316,398032,3035,10901351,0.999721594140029,1428487
BW_21084,BW_21084_idx_718,BW_01104,9229893,334007,2541,9232434,0.999724774636894,1159890
BW_24562,BW_24562_idx_719,BW_01104,14520266,536277,4025,14524291,0.999722878039279,2127668
NA,TA1659,BW_01104,513298,20409,293,513591,0.999429507137002,NA
TOWWC105,TOWWC105_idx_135,BW_01104,1345102,42773,292,1345394,0.999782963206317,153111
BW_21085,BW_21085_idx_720,BW_01105,11689574,567929,7124,11696698,0.999390939220624,1679517
BW_21086,BW_21086_idx_721,BW_01105,8466425,453849,56995,8523420,0.993313130175446,1255604
BW_21087,BW_21087_idx_722,BW_01105,12354280,657236,179833,12534113,0.985652514860844,1840605
BW_21088,BW_21088_idx_1004,BW_01105,5535800,262326,3132,5538932,0.999434548032003,706062
BW_21088,BW_21088_idx_723,BW_01105,11805776,630427,176510,11982286,0.985269088052146,1723802
NA,TA1661,BW_01105,610434,22292,897,611331,0.998532709775882,NA
TOWWC106,TOWWC106_idx_143,BW_01105,853180,34627,378,853558,0.999557147844669,105234
BW_21091,BW_21091_idx_724,BW_01106,6798034,264498,3671,6801705,0.999460282385078,878407
BW_21092,BW_21092_idx_725,BW_01106,7358656,286180,3176,7361832,0.99956858564553,935178
BW_21093,BW_21093_idx_726,BW_01106,7050710,343510,74426,7125136,0.989554444995857,959798
BW_21094,BW_21094_idx_727,BW_01106,9515791,468928,101291,9617082,0.989467595264343,1382705
BW_21094,BW_21094_idx_821,BW_01106,2845357,111328,1666,2847023,0.999414827347724,354570
BW_26833,BW_26833_idx_966,BW_01106,6975802,269394,2654,6978456,0.999619686647018,855304
NA,TA1662,BW_01106,499671,16952,459,500130,0.999082238617959,NA
TOWWC107,TOWWC107_idx_151,BW_01106,1803509,61239,454,1803963,0.999748331867117,156747
BW_21095,BW_21095_idx_728,BW_01107,11463694,624440,72584,11536278,0.993708196005679,1785403
BW_21096,BW_21096_idx_729,BW_01107,10700006,515606,6472,10706478,0.999395506159916,1598627
BW_21097,BW_21097_idx_730,BW_01107,9491867,449656,5629,9497496,0.999407317465572,1337724
BW_21098,BW_21098_idx_731,BW_01107,10856880,521948,6433,10863313,0.999407823377638,1610001
BW_21098,BW_21098_idx_822,BW_01107,7053805,331042,3841,7057646,0.99945576754629,923310
BW_25776,BW_25776_idx_732,BW_01107,7865867,371234,4505,7870372,0.99942760011852,1073684
NA,TA1664,BW_01107,471683,17355,665,472348,0.998592139693616,NA
TOWWC108,TOWWC108_idx_159,BW_01107,1533578,62411,547,1534125,0.999643444960482,165560
BW_21099,BW_21099_idx_733,BW_01108,327895,11442,276,328171,0.999158975046546,54463
BW_21100,BW_21100_idx_734,BW_01108,4742449,165921,1195,4743644,0.999748083962456,541443
BW_21101,BW_21101_idx_735,BW_01108,10420260,392249,2897,10423157,0.999722061175899,1667482
BW_21102,BW_21102_idx_736,BW_01108,13800091,499060,3515,13803606,0.999745356394554,1876560
BW_21103,BW_21103_idx_1005,BW_01108,5122714,175823,1207,5123921,0.999764438210503,562012
BW_21103,BW_21103_idx_737,BW_01108,12712185,458088,3195,12715380,0.999748729491372,1705822
BW_21103,BW_21103_idx_823,BW_01108,3455884,122634,946,3456830,0.999726338871162,479656
NA,TA1665,BW_01108,1433133,52330,706,1433839,0.999507615569112,NA
TOWWC109,TOWWC109_idx_167,BW_01108,1899102,59618,405,1899507,0.999786786782044,148083
BW_21104,BW_21104_idx_738,BW_01109,11544615,408128,3154,11547769,0.999726873649793,1513038
BW_21105,BW_21105_idx_739,BW_01109,15837246,568476,4086,15841332,0.999742067144354,2128835
BW_21106,BW_21106_idx_740,BW_01109,10095509,355198,2552,10098061,0.999747278215095,1281480
BW_21106,BW_21106_idx_873,BW_01109,5650695,220961,31268,5681963,0.994496972261171,743666
BW_21107,BW_21107_idx_741,BW_01109,11811155,423733,3052,11814207,0.999741666960804,1619418
BW_21108,BW_21108_idx_742,BW_01109,1351710,48269,484,1352194,0.999642063195074,242091
BW_25779,BW_25779_idx_743,BW_01109,15889674,569161,4157,15893831,0.999738451981778,2125453
NA,TA1666,BW_01109,846737,31760,465,847202,0.999451134440193,NA
TOWWC110,TOWWC110_idx_175,BW_01109,1818481,55511,340,1818821,0.999813065716747,184170
NA,TA1667,BW_01110,1415730,50909,791,1416521,0.9994415896411,NA
BW_21112,BW_21112_idx_744,BW_01111,9883460,345022,2660,9886120,0.999730935898007,1211012
BW_21113,BW_21113_idx_745,BW_01111,6168779,215349,1704,6170483,0.999723846577326,730203
BW_21114,BW_21114_idx_1006,BW_01111,5752185,197526,1418,5753603,0.999753545734734,650290
BW_21114,BW_21114_idx_746,BW_01111,7778210,275573,2064,7780274,0.999734713713167,1028225
NA,TA1668,BW_01111,677137,22145,274,677411,0.999595518820923,NA
TOWWC112,TOWWC112_idx_183,BW_01111,848440,25919,186,848626,0.999780822176082,72751
BW_21117,BW_21117_idx_1007,BW_01112,5857148,201007,1589,5858737,0.99972878113491,725223
BW_21117,BW_21117_idx_1017,BW_01112,13865008,477167,3599,13868607,0.999740493043029,1937887
BW_21117,BW_21117_idx_747,BW_01112,17154020,592669,4546,17158566,0.999735059444944,2365908
NA,TA1669,BW_01112,1287994,44670,664,1288658,0.999484735282752,NA
BW_21119,BW_21119_idx_748,BW_01113,10906665,510728,6372,10913037,0.999416111207174,1576419
BW_21120,BW_21120_idx_749,BW_01113,9465178,441799,5412,9470590,0.999428546690333,1318854
BW_21121,BW_21121_idx_750,BW_01113,10674000,503305,6054,10680054,0.999433148933517,1555414
BW_25784,BW_25784_idx_751,BW_01113,16720677,789454,9287,16729964,0.999444888225701,2521107
NA,TA1670,BW_01113,571742,20368,810,572552,0.998585281336892,NA
TOWWC114,TOWWC114_idx_191,BW_01113,313522,12391,174,313696,0.999445322860349,27543
BW_21123,BW_21123_idx_752,BW_01114,11693472,424463,2987,11696459,0.999744623565132,1616536
BW_21124,BW_21124_idx_753,BW_01114,11007859,415287,19311,11027170,0.99824878005871,1602735
BW_21125,BW_21125_idx_754,BW_01114,11302085,408206,3083,11305168,0.999727292862875,1518404
BW_21126,BW_21126_idx_755,BW_01114,11141830,400353,2796,11144626,0.999749116749185,1471427
BW_21127,BW_21127_idx_756,BW_01114,9725891,349870,2448,9728339,0.999748364032133,1278776
NA,TA1673,BW_01114,344532,12175,147,344679,0.999573516228143,NA
TOWWC115,TOWWC115_idx_104,BW_01114,4060063,132797,905,4060968,0.999777146729548,337898
BW_21129,BW_21129_idx_757,BW_01115,9528152,365798,3574,9531726,0.999625041676607,1258085
BW_21130,BW_21130_idx_758,BW_01115,10773275,413918,4014,10777289,0.999627550119515,1450545
BW_21131,BW_21131_idx_759,BW_01115,9599226,369179,3631,9602857,0.99962188336242,1284824
BW_21132,BW_21132_idx_760,BW_01115,12279640,478790,4822,12284462,0.999607471617398,1808525
BW_21133,BW_21133_idx_761,BW_01115,14247947,554794,7720,14255667,0.999458460975554,2017020
BW_21133,BW_21133_idx_894,BW_01115,7550399,289378,2863,7553262,0.99962095846801,997493
NA,TA1675,BW_01115,407418,17919,441,407859,0.998918743977698,NA
TOWWC116,TOWWC116_idx_112,BW_01115,4563791,156841,1211,4565002,0.999734720817209,407539
BW_21135,BW_21135_idx_762,BW_01116,9548122,340745,2621,9550743,0.999725571089077,1237136
BW_21136,BW_21136_idx_763,BW_01116,9980695,357737,2453,9983148,0.999754285922637,1284498
BW_21137,BW_21137_idx_764,BW_01116,10795174,383613,2670,10797844,0.999752728415043,1400932
BW_21137,BW_21137_idx_883,BW_01116,7482231,268699,1909,7484140,0.999744927272873,969903
NA,TA1677,BW_01116,355811,14282,176,355987,0.999505599923593,NA
TOWWC117,TOWWC117_idx_120,BW_01116,5314798,171647,1178,5315976,0.999778403815217,441992
BW_21138,BW_21138_idx_765,BW_01117,15331032,552313,4008,15335040,0.999738637786403,2222219
BW_21139,BW_21139_idx_766,BW_01117,11737922,416801,3020,11740942,0.999742780434483,1501325
BW_21140,BW_21140_idx_767,BW_01117,18189134,682923,4958,18194092,0.999727493957929,3024757
BW_21141,BW_21141_idx_768,BW_01117,14861742,532168,3778,14865520,0.999745854837234,2209959
BW_21141,BW_21141_idx_901,BW_01117,5248174,183403,1348,5249522,0.999743214715549,615322
NA,TA1678,BW_01117,1038037,35458,410,1038447,0.9996051796577,NA
TOWWC118,TOWWC118_idx_128,BW_01117,4481404,141844,998,4482402,0.999777351518226,366931
BW_21142,BW_21142_idx_929,BW_01118,3597802,119658,883,3598685,0.999754632594962,307798
BW_21143,BW_21143_idx_930,BW_01118,8319253,291437,2096,8321349,0.999748117763117,976900
BW_21144,BW_21144_idx_931,BW_01118,6510846,225828,1619,6512465,0.999751399815584,749304
BW_21145,BW_21145_idx_932,BW_01118,7618348,264073,1733,7620081,0.999772574595992,888290
BW_21146,BW_21146_idx_933,BW_01118,6393511,222605,1580,6395091,0.999752935493803,784309
BW_21147,BW_21147_idx_934,BW_01118,4505008,158977,1209,4506217,0.999731703999164,591080
NA,TA1679,BW_01118,880417,29630,338,880755,0.999616238340969,NA
TOWWC119,TOWWC119_idx_136,BW_01118,3947776,124541,798,3948574,0.999797901723508,318141
BW_21148,BW_21148_idx_935,BW_01119,2652400,90675,785,2653185,0.999704129188127,276514
BW_21149,BW_21149_idx_874,BW_01119,4915482,176842,1470,4916952,0.999701034299298,696796
BW_21149,BW_21149_idx_936,BW_01119,10104734,357980,2623,10107357,0.999740486063765,1291531
BW_21150,BW_21150_idx_937,BW_01119,2373625,78724,549,2374174,0.999768761683011,193108
BW_21151,BW_21151_idx_938,BW_01119,4464141,157667,1145,4465286,0.999743577455061,505807
BW_25786,BW_25786_idx_967,BW_01119,9469238,335804,2463,9471701,0.999739962230649,1240072
NA,TA1680,BW_01119,1672792,61023,929,1673721,0.999444949307561,NA
TOWWC120,TOWWC120_idx_144,BW_01119,1385427,42585,371,1385798,0.999732284214582,129140
BW_21153,BW_21153_idx_939,BW_01120,5413978,183222,1255,5415233,0.999768246352465,540810
BW_21154,BW_21154_idx_940,BW_01120,2298089,78850,625,2298714,0.999728108846947,243034
BW_21155,BW_21155_idx_941,BW_01120,4113062,139810,1042,4114104,0.999746724924795,422683
BW_21156,BW_21156_idx_881,BW_01120,7472133,263479,2213,7474346,0.999703920583821,1154282
BW_21156,BW_21156_idx_942,BW_01120,4105470,142190,1080,4106550,0.999737005515579,481734
NA,TA1682,BW_01120,576521,19457,205,576726,0.999644545243322,NA
TOWWC121,TOWWC121_idx_193,BW_01120,8026295,275882,1889,8028184,0.999764703947991,914947
BW_21157,BW_21157_idx_943,BW_01121,3961840,157441,25082,3986922,0.993708931351052,559892
BW_21158,BW_21158_idx_944,BW_01121,6872171,276712,45245,6917416,0.993459262822996,945598
BW_21159,BW_21159_idx_945,BW_01121,11422032,415248,4448,11426480,0.999610728763364,1535113
BW_21160,BW_21160_idx_946,BW_01121,6323274,228681,3054,6326328,0.99951725550746,781785
BW_21161,BW_21161_idx_887,BW_01121,8564125,322103,31739,8595864,0.996307642838463,1072633
BW_21161,BW_21161_idx_947,BW_01121,2057242,76453,7693,2064935,0.996274459002341,236046
BW_21162,BW_21162_idx_948,BW_01121,4702437,168025,2541,4704978,0.999459933712761,552074
NA,TA1683,BW_01121,838839,27639,451,839290,0.999462641041833,NA
TOWWC122,TOWWC122_idx_194,BW_01121,6556325,255160,40637,6596962,0.993840043341162,788266
BW_21164,BW_21164_idx_895,BW_01122,6474125,224101,1542,6475667,0.999761877811197,711079
BW_21164,BW_21164_idx_949,BW_01122,4378285,151353,966,4379251,0.999779414333638,451516
BW_25789,BW_25789_idx_950,BW_01122,2605637,89765,682,2606319,0.999738328270638,384791
NA,TA1684,BW_01122,637401,21676,193,637594,0.999697299535441,NA
TOWWC123,TOWWC123_idx_195,BW_01122,7997197,275271,1824,7999021,0.999771972095085,909192
BW_21165,BW_21165_A_idx_902,BW_01123,7570249,268055,1947,7572196,0.999742875118394,901280
BW_21165,BW_21165_idx_951,BW_01123,1284753,43297,345,1285098,0.999731537983874,115798
BW_21166,BW_21166_idx_952,BW_01123,8193712,293070,2099,8195811,0.999743893557331,1110149
BW_21167,BW_21167_idx_953,BW_01123,10710305,384388,2902,10713207,0.999729119394407,1541071
BW_21168,BW_21168_idx_954,BW_01123,10531466,373941,2745,10534211,0.999739420446391,1357316
BW_25791,BW_25791_idx_968,BW_01123,9280124,333413,2444,9282568,0.999736710789514,1205905
NA,TA1685,BW_01123,1494005,55131,824,1494829,0.999448766380636,NA
TOWWC124,TOWWC124_idx_196,BW_01123,9586442,333503,2330,9588772,0.99975700746665,1109622
BW_21171,BW_21171_idx_955,BW_01124,491779,16437,154,491933,0.999686949239022,41602
BW_21172,BW_21172_idx_956,BW_01124,2402275,85183,707,2402982,0.999705782232243,283442
BW_21173,BW_21173_idx_957,BW_01124,3825398,136506,1009,3826407,0.9997363061483,436765
NA,TA1686,BW_01124,315340,13048,1751,317091,0.99447792589509,NA
TOWWC125,TOWWC125_idx_197,BW_01124,9177266,331050,2268,9179534,0.999752928634504,1107668
BW_21174,BW_21174_idx_958,BW_01125,2412294,88106,718,2413012,0.999702446568853,271801
BW_21175,BW_21175_idx_875,BW_01125,5979990,222620,1983,5981973,0.999668504020329,749561
BW_25793,BW_25793_idx_959,BW_01125,848743,30006,382,849125,0.999550125128809,85171
NA,TA1690,BW_01125,1253057,62183,16568,1269625,0.9869504775032,NA
TOWWC126,TOWWC126_idx_198,BW_01125,8101987,297789,2321,8104308,0.99971360910765,957368
BW_21179,BW_21179_idx_960,BW_01126,7891186,375646,4534,7895720,0.999425764844751,1053719
BW_21180,BW_21180_idx_769,BW_01126,5742379,265702,3298,5745677,0.999426003236868,726674
BW_21181,BW_21181_idx_770,BW_01126,9462180,450788,5687,9467867,0.999399336724946,1404617
BW_21182,BW_21182_idx_771,BW_01126,2189910,93426,830,2190740,0.999621132585336,203622
BW_25795,BW_25795_idx_772,BW_01126,5369229,246425,3098,5372327,0.999423341133181,701194
NA,TA1691,BW_01126,489815,17543,923,490738,0.998119159307003,NA
TOWWC127,TOWWC127_idx_199,BW_01126,5770401,269573,3216,5773617,0.999442983488513,745850
BW_21190,BW_21190_idx_773,BW_01128,4688682,201173,2330,4691012,0.99950330547012,722900
BW_21191,BW_21191_idx_774,BW_01128,5608210,241212,2797,5611007,0.999501515503367,901761
BW_21192,BW_21192_idx_775,BW_01128,6060597,261537,3029,6063626,0.999500463913836,958079
BW_21193,BW_21193_idx_1014,BW_01128,6370818,268192,2894,6373712,0.999545947479271,810188
BW_21193,BW_21193_idx_776,BW_01128,5709973,247443,2872,5712845,0.999497273250018,869282
BW_25798,BW_25798_idx_777,BW_01128,8010395,344977,4063,8014458,0.999493041201289,1255971
NA,TA1695,BW_01128,624212,24975,993,625205,0.998411720955527,NA
TOWWC129,TOWWC129_idx_200,BW_01128,7082044,296006,3112,7085156,0.999560771844685,865497
BW_21194,BW_21194_idx_778,BW_01129,10351865,497370,6044,10357909,0.999416484543357,1561679
BW_21195,BW_21195_idx_779,BW_01129,2968964,129130,1302,2970266,0.99956165542076,281931
BW_21196,BW_21196_idx_780,BW_01129,7699924,363297,4347,7704271,0.999435767511293,1093344
BW_21197,BW_21197_idx_781,BW_01129,6677224,325525,4212,6681436,0.999369596595702,1027057
BW_21198,BW_21198_idx_782,BW_01129,6659223,319579,4151,6663374,0.999377042321202,1013683
BW_21198,BW_21198_idx_888,BW_01129,8068139,388100,4661,8072800,0.999422629075414,1062165
NA,TA1696,BW_01129,458162,16579,813,458975,0.998228661691813,NA
TOWWC130,TOWWC130_idx_201,BW_01129,14389163,693903,8378,14397541,0.999418095076097,2173365
BW_21200,BW_21200_idx_783,BW_01130,10170194,477083,6307,10176501,0.999380238846338,1493034
BW_21201,BW_21201_idx_1018,BW_01130,9732392,452133,5684,9738076,0.99941631180533,1371663
BW_21201,BW_21201_idx_784,BW_01130,7010248,331205,4631,7014879,0.99933983180608,988567
BW_21202,BW_21202_idx_785,BW_01130,9085380,419862,5816,9091196,0.999360260190188,1602720
BW_25800,BW_25800_idx_786,BW_01130,9028848,414177,5195,9034043,0.999424952925285,1119471
NA,TA1703,BW_01130,476525,17118,978,477503,0.99795184532872,NA
TOWWC131,TOWWC131_idx_202,BW_01130,9519977,443151,5628,9525605,0.999409171385964,1334623
BW_21209,BW_21209_idx_649,BW_01132,5620520,269431,3341,5623861,0.999405924150686,826994
BW_21210,BW_21210_idx_657,BW_01132,9538247,468110,5811,9544058,0.999391139492237,1442617
BW_21211,BW_21211_idx_665,BW_01132,7848220,384168,4995,7853215,0.999363954762476,1225956
BW_21212,BW_21212_idx_865,BW_01132,2971352,142566,1808,2973160,0.999391892800926,380230
BW_21212,BW_21212_idx_903,BW_01132,3931490,188617,2350,3933840,0.999402619323613,548640
BW_21213,BW_21213_idx_642,BW_01132,11205715,542448,6397,11212112,0.999429456287986,1609646
NA,TA1715,BW_01132,440361,16114,666,441027,0.998489888374181,NA
TOWWC133,TOWWC133_idx_203,BW_01132,9357645,447851,5115,9362760,0.999453686733399,1231348
BW_21215,BW_21215_idx_650,BW_01133,9030750,334504,2517,9033267,0.999721363267575,1212916
BW_21216,BW_21216_idx_658,BW_01133,11908902,439854,3296,11912198,0.999723308830159,1609266
BW_21217,BW_21217_idx_666,BW_01133,7833933,287605,2379,7836312,0.999696413312793,1045685
BW_21218,BW_21218_idx_866,BW_01133,6732167,249467,2148,6734315,0.999681036601347,918772
BW_21218,BW_21218_idx_876,BW_01133,4342782,159736,1406,4344188,0.999676349181941,582052
BW_21219,BW_21219_idx_643,BW_01133,9686771,352752,2786,9689557,0.999712473955208,1167614
NA,TA1718,BW_01133,844950,28413,645,845595,0.999237223493516,NA
TOWWC134,TOWWC134_idx_204,BW_01133,7679624,274706,2145,7681769,0.99972076744302,859529
BW_24582,BW_24582_idx_651,BW_01134,10386497,377126,2849,10389346,0.999725776771704,1245725
NA,TA2369,BW_01134,646980,21805,360,647340,0.999443878023913,NA
TOWWC135,TOWWC135_idx_240,BW_01134,8481451,305766,2263,8483714,0.999733253619818,997642
BW_21226,BW_21226_idx_668,BW_01136,7616530,280239,2529,7619059,0.999668069245822,955606
BW_21227,BW_21227_idx_868,BW_01136,5862568,217152,1998,5864566,0.999659309827871,760278
BW_21228,BW_21228_idx_645,BW_01136,8488809,313566,2651,8491460,0.999687803981883,1063107
BW_21229,BW_21229_A_idx_889,BW_01136,5979207,215765,1901,5981108,0.999682165913072,650122
BW_21229,BW_21229_B_idx_896,BW_01136,8708884,321046,2774,8711658,0.999681576113296,1081533
BW_21229,BW_21229_C_idx_904,BW_01136,4066441,150798,1427,4067868,0.999649201989838,452473
BW_25833,BW_25833_idx_653,BW_01136,9839581,361663,3134,9842715,0.99968159191849,1241711
NA,TA2376,BW_01136,1789099,68277,1744,1790843,0.999026156955132,NA
TOWWC137,TOWWC137_idx_237,BW_01136,4772778,170916,1400,4774178,0.999706755801732,510682
BW_21231,BW_21231_idx_669,BW_01137,9955298,430070,4605,9959903,0.999537646099565,1458043
BW_21231,BW_21231_idx_877,BW_01137,2622194,111288,1298,2623492,0.999505239581443,331278
BW_21232,BW_21232_idx_869,BW_01137,4470060,193289,2118,4472178,0.999526405254889,592457
BW_21233,BW_21233_idx_646,BW_01137,9371924,403637,4384,9376308,0.999532438567504,1349265
BW_21234,BW_21234_idx_654,BW_01137,9211900,397036,4126,9216026,0.99955230161026,1270935
BW_21235,BW_21235_idx_662,BW_01137,8172798,351380,3853,8176651,0.999528780181519,1163338
BW_21236,BW_21236_idx_670,BW_01137,7395507,320184,3349,7398856,0.999547362457115,1060636
NA,TA2377,BW_01137,582100,19635,615,582715,0.998944595557005,NA
TOWWC138,TOWWC138_idx_242,BW_01137,7552323,321718,3258,7555581,0.999568795569791,947600
BW_21237,BW_21237_idx_870,BW_01138,5746468,284921,3801,5750269,0.999338987445631,919488
BW_21238,BW_21238_idx_647,BW_01138,11438171,559853,7092,11445263,0.999380354999269,1566749
BW_21239,BW_21239_idx_655,BW_01138,10551112,518428,6322,10557434,0.999401180248913,1431251
BW_21240,BW_21240_idx_663,BW_01138,8625160,425581,5401,8630561,0.999374200587888,1204983
BW_21241,BW_21241_idx_671,BW_01138,5625376,272182,3389,5628765,0.999397914107269,689585
BW_21242,BW_21242_idx_871,BW_01138,2698591,132554,1741,2700332,0.999355264463777,397638
BW_21243,BW_21243_idx_1019,BW_01138,5592621,268757,3211,5595832,0.999426180056871,697817
BW_21243,BW_21243_idx_648,BW_01138,13809370,685005,8823,13818193,0.999361493937738,2018139
BW_21243,BW_21243_idx_890,BW_01138,8145108,405318,5798,8150906,0.999288668032732,1119184
BW_21244,BW_21244_idx_656,BW_01138,11975418,590279,7377,11982795,0.999384367336669,1660057
NA,TA2378,BW_01138,1668830,90560,4330,1673160,0.997412082526477,NA
TOWWC139,TOWWC139_idx_241,BW_01138,7063589,340099,4099,7067688,0.999420036651307,906789
BW_21245,BW_21245_A_idx_897,BW_01139,4015072,144045,1174,4016246,0.999707687228322,365861
BW_21245,BW_21245_B_idx_905,BW_01139,4885244,178664,1484,4886728,0.999696320319036,560900
BW_21245,BW_21245_idx_664,BW_01139,8833370,330749,2516,8835886,0.999715252098092,1160533
BW_21245,BW_21245_idx_878,BW_01139,5380520,201947,1754,5382274,0.999674115438939,723144
BW_21246,BW_21246_idx_672,BW_01139,9187858,347894,2746,9190604,0.999701216590335,1291253
BW_21247,BW_21247_idx_872,BW_01139,6203895,233446,1876,6205771,0.999697700736943,777806
BW_21248,BW_21248_idx_601,BW_01139,11690876,435960,3554,11694430,0.999696094636506,1584305
BW_21249,BW_21249_idx_609,BW_01139,9952133,367010,2975,9955108,0.999701158440471,1331356
BW_21250,BW_21250_idx_617,BW_01139,12366531,466507,3615,12370146,0.999707764160585,1756245
BW_25838,BW_25838_idx_969,BW_01139,9992333,372179,2948,9995281,0.9997050608182,1272159
NA,TA2446,BW_01139,1595861,60940,1188,1597049,0.999256128021119,NA
TOWWC140,TOWWC140_idx_234,BW_01139,8007891,300317,2179,8010070,0.999727967421009,989290
BW_21251,BW_21251_idx_633,BW_01140,8117559,349045,3827,8121386,0.999528775014511,1137643
BW_21252,BW_21252_idx_602,BW_01140,8557834,367395,4040,8561874,0.999528140685088,1154815
BW_21254,BW_21254_idx_610,BW_01140,7735709,328636,3478,7739187,0.999550598790286,1088327
BW_21255,BW_21255_idx_618,BW_01140,7128867,303075,3305,7132172,0.999536606800846,976103
BW_21255,BW_21255_idx_884,BW_01140,7257483,313496,3410,7260893,0.999530360797219,1035511
NA,TA2449,BW_01140,483974,16206,513,484487,0.9989411480597,NA
TOWWC141,TOWWC141_idx_238,BW_01140,3880796,160214,1620,3882416,0.999582734050138,440891
BW_21257,BW_21257_A_idx_891,BW_01141,7570438,319678,3300,7573738,0.999564283845045,951355
BW_21257,BW_21257_B_idx_898,BW_01141,3137431,128631,1400,3138831,0.999553974075062,484799
BW_21257,BW_21257_idx_626,BW_01141,9902549,421537,4529,9907078,0.999542852090192,1361930
BW_21258,BW_21258_C_idx_906,BW_01141,6641638,279255,3015,6644653,0.999546251700427,866285
BW_21258,BW_21258_idx_634,BW_01141,6191547,263189,2763,6194310,0.999553945475767,840883
BW_25842,BW_25842_idx_970,BW_01141,6043203,254652,2504,6045707,0.99958582180711,749747
NA,TA2451,BW_01141,319571,10823,296,319867,0.99907461538702,NA
TOWWC142,TOWWC142_idx_236,BW_01141,5204390,216946,2084,5206474,0.999599729106493,618990
BW_21262,BW_21262_idx_611,BW_01142,6437105,272206,2992,6440097,0.999535410724404,850481
BW_21262,BW_21262_idx_879,BW_01142,5301222,227206,2486,5303708,0.999531271329417,637802
BW_21263,BW_21263_idx_619,BW_01142,5422384,227670,2411,5424795,0.999555559242331,706169
BW_25844,BW_25844_idx_627,BW_01142,8953319,381256,4039,8957358,0.999549085790699,1227394
NA,TA2452,BW_01142,615076,20603,621,615697,0.998991386997176,NA
TOWWC143,TOWWC143_idx_239,BW_01142,4270707,177720,1759,4272466,0.999588293973551,502836
BW_21266,BW_21266_idx_635,BW_01143,5952886,257157,2943,5955829,0.999505862240168,844599
BW_21267,BW_21267_idx_604,BW_01143,7539579,322745,3516,7543095,0.999533878335087,950204
BW_25846,BW_25846_idx_612,BW_01143,329191,13147,418,329609,0.998731830744913,32651
BW_25849,BW_25849_idx_971,BW_01143,6953205,295976,3217,6956422,0.999537549619618,885122
NA,TA2453,BW_01143,716391,24734,830,717221,0.998842755580219,NA
TOWWC144,TOWWC144_idx_233,BW_01143,2316858,94012,1002,2317860,0.999567704693122,254180
BW_21268,BW_21268_idx_628,BW_01144,6176313,262328,2935,6179248,0.999525023109608,804760
BW_21268,BW_21268_idx_885,BW_01144,10554079,455413,4938,10559017,0.999532342830777,1408950
BW_21270,BW_21270_idx_636,BW_01144,3577825,152293,1764,3579589,0.999507205994878,462518
BW_25858,BW_25858_idx_605,BW_01144,5405004,228614,2472,5407476,0.99954285511392,748194
BW_25859,BW_25859_idx_613,BW_01144,5046600,212598,2240,5048840,0.999556333732105,702224
NA,TA2454,BW_01144,272743,9400,303,273046,0.998890296873054,NA
TOWWC145,TOWWC145_idx_244,BW_01144,1511181,63150,707,1511888,0.999532372768353,200564
BW_21276,BW_21276_idx_621,BW_01146,8257127,415852,124881,8382008,0.985101302695011,1181004
BW_21277,BW_21277_idx_629,BW_01146,6252412,263928,2949,6255361,0.999528564378619,826488
BW_21278,BW_21278_idx_637,BW_01146,6437505,272906,3097,6440602,0.999519144328434,863625
BW_21279,BW_21279_idx_892,BW_01146,7361214,313435,3552,7364766,0.999517703617467,1021308
BW_25864,BW_25864_idx_606,BW_01146,4738370,200030,2547,4740917,0.999462762161835,688305
BW_25866,BW_25866_idx_972,BW_01146,10446223,445788,5038,10451261,0.999517952905396,1442058
NA,TA2457,BW_01146,3761387,159273,5371,3766758,0.99857410537125,NA
TOWWC147,TOWWC147_idx_235,BW_01146,2557263,102097,1103,2558366,0.999568865439894,277938
BW_21281,BW_21281_idx_622,BW_01147,8767308,423086,104324,8871632,0.988240720534846,1228666
BW_21282,BW_21282_idx_630,BW_01147,6580810,246273,1995,6582805,0.999696937703608,825127
BW_21283,BW_21283_idx_638,BW_01147,6359642,241673,1868,6361510,0.999706359024823,778389
BW_21283,BW_21283_idx_899,BW_01147,10594491,399825,3144,10597635,0.999703330035428,1349891
BW_25871,BW_25871_idx_607,BW_01147,11214607,424373,3256,11217863,0.999709748639291,1454570
NA,TA2459,BW_01147,819612,27441,496,820108,0.999395201607593,NA
TOWWC148,TOWWC148_idx_152,BW_01147,2691581,92561,629,2692210,0.999766362950884,243562
BW_21284,BW_21284_idx_615,BW_01148,7683903,285936,2396,7686299,0.999688276503425,1036167
BW_21285,BW_21285_idx_623,BW_01148,13637602,510214,4004,13641606,0.999706486171789,1856199
BW_21285,BW_21285_idx_907,BW_01148,2270656,83349,765,2271421,0.999663206424525,329331
BW_21286,BW_21286_idx_631,BW_01148,7707166,287639,2320,7709486,0.999699072026332,947655
BW_25875,BW_25875_idx_639,BW_01148,8908611,331518,2637,8911248,0.999704081852508,1144993
BW_25876,BW_25876_idx_608,BW_01148,14933608,570478,4597,14938205,0.99969226557006,2248487
NA,TA2460,BW_01148,628883,21450,363,629246,0.999423119098095,NA
TOWWC149,TOWWC149_idx_160,BW_01148,4660429,158220,1103,4661532,0.999763382510299,406733
BW_21299,BW_21299_idx_616,BW_01151,10228825,449578,4659,10233484,0.999544729830036,1379486
BW_21300,BW_21300_idx_624,BW_01151,13902849,615259,6450,13909299,0.999536281447397,2019817
BW_21301,BW_21301_idx_632,BW_01151,11867321,524972,5558,11872879,0.999531874282556,1674353
BW_21302,BW_21302_idx_640,BW_01151,8427509,372647,3936,8431445,0.999533176104452,1161901
BW_25880,BW_25880_idx_465,BW_01151,9910574,447726,5238,9915812,0.999471752792409,1614827
NA,TA2465,BW_01151,395141,13325,411,395552,0.998960945716366,NA
TOWWC152,TOWWC152_idx_168,BW_01151,3767694,146786,1182,3768876,0.999686378644455,335669
BW_21303,BW_21303_idx_473,BW_01152,10050697,434516,5099,10055796,0.999492929251946,1368104
BW_21304,BW_21304_idx_577,BW_01152,9796007,419453,4683,9800690,0.999522176499818,1362897
BW_21304,BW_21304_idx_893,BW_01152,2992415,122240,1324,2993739,0.999557743677722,346342
BW_21305,BW_21305_idx_585,BW_01152,10058567,436436,4953,10063520,0.999507826287422,1387232
BW_21306,BW_21306_idx_593,BW_01152,3636021,161293,2209,3638230,0.999392836626601,996013
BW_25883,BW_25883_idx_466,BW_01152,5014959,213069,2342,5017301,0.999533215168873,590558
NA,TA2466,BW_01152,726201,24063,792,726993,0.99891058098221,NA
TOWWC153,TOWWC153_idx_176,BW_01152,2663061,100033,778,2663839,0.999707940307203,233438
BW_21308,BW_21308_idx_900,BW_01153,8717504,383538,4674,8722178,0.999464124671613,1240748
BW_21309,BW_21309_idx_474,BW_01153,9804107,441308,5207,9809314,0.999469177966981,1459161
BW_21310,BW_21310_idx_578,BW_01153,11806623,519134,6034,11812657,0.999489191974337,1669306
BW_25889,BW_25889_idx_973,BW_01153,4856164,212111,2396,4858560,0.999506849766186,617540
NA,TA2467,BW_01153,503156,17353,551,503707,0.998906110099721,NA
TOWWC154,TOWWC154_idx_184,BW_01153,2352410,91652,818,2353228,0.99965239237337,220076
BW_21312,BW_21312_idx_594,BW_01154,11188757,494426,5317,11194074,0.999525016540001,1539871
BW_21314,BW_21314_idx_1008,BW_01154,12547695,567325,5929,12553624,0.999527706103034,1768743
BW_21315,BW_21315_idx_467,BW_01154,5838115,263274,2908,5841023,0.999502142004919,785963
BW_25892,BW_25892_idx_974,BW_01154,8184621,362859,3848,8188469,0.999530070883825,1117035
NA,TA2469,BW_01154,747931,25765,818,748749,0.998907511061784,NA
TOWWC155,TOWWC155_idx_192,BW_01154,1147149,43150,355,1147504,0.999690632886683,163090
BW_21318,BW_21318_idx_579,BW_01155,12694165,584750,6986,12701151,0.999449971108918,1837310
BW_25895,BW_25895_idx_1013,BW_01155,3311824,147253,1679,3313503,0.999493285504797,398887
BW_25895,BW_25895_idx_587,BW_01155,7703714,351826,4077,7707791,0.999471054677014,1077515
BW_25896,BW_25896_idx_975,BW_01155,9019687,415417,4931,9024618,0.999453605681703,1269777
NA,TA2470,BW_01155,482495,17143,604,483099,0.998749738666402,NA
TOWWC156,TOWWC156_idx_205,BW_01155,7199689,329945,3908,7203597,0.999457493249553,905137
BW_21320,BW_21320_idx_468,BW_01156,11973962,578496,6999,11980961,0.999415823154754,1789919
BW_21321,BW_21321_idx_476,BW_01156,11126624,536060,6397,11133021,0.999425403041996,1558615
BW_21322,BW_21322_idx_580,BW_01156,12092854,577003,6651,12099505,0.999450308091116,1727375
BW_21323,BW_21323_idx_588,BW_01156,9641803,457873,5360,9647163,0.999444396243745,1342576
BW_21323,BW_21323_idx_910,BW_01156,6447323,307652,3578,6450901,0.999445348797013,896035
BW_25902,BW_25902_idx_596,BW_01156,4701457,218208,2441,4703898,0.999481068679635,572124
NA,TA2471,BW_01156,715162,25441,990,716152,0.998617611903618,NA
TOWWC157,TOWWC157_idx_206,BW_01156,8807208,418395,4870,8812078,0.999447349422009,1200109
BW_21330,BW_21330_idx_469,BW_01158,7177498,352165,4709,7182207,0.999344351951984,1200475
BW_21331,BW_21331_idx_477,BW_01158,9920592,472741,5715,9926307,0.999424257178425,1433984
BW_21332,BW_21332_idx_581,BW_01158,9491620,442606,5067,9496687,0.999466445508839,1303305
BW_21333,BW_21333_idx_589,BW_01158,4848165,222883,2580,4850745,0.999468122937817,650352
BW_21334,BW_21334_idx_597,BW_01158,7686956,385149,36284,7723240,0.995301971711354,1070808
NA,TA2474,BW_01158,1593846,79615,3075,1596921,0.99807441946095,NA
TOWWC159,TOWWC159_idx_207,BW_01158,6389484,297269,3458,6392942,0.99945909097877,806600
BW_21336,BW_21336_idx_470,BW_01159,5215514,235535,2784,5218298,0.999466492714674,847047
BW_21337,BW_21337_idx_478,BW_01159,10175581,477499,5664,10181245,0.999443682968046,1540898
BW_21337,BW_21337_idx_909,BW_01159,2860650,122477,1442,2862092,0.999496172729598,404974
BW_25906,BW_25906_idx_976,BW_01159,8794352,410910,5053,8799405,0.999425756627863,1271649
NA,TA2475,BW_01159,427573,21192,879,428452,0.997948428295352,NA
TOWWC160,TOWWC160_idx_208,BW_01159,8210565,375977,4420,8214985,0.999461958847155,1062183
BW_21344,BW_21344_idx_590,BW_01161,6102849,297882,3663,6106512,0.999400148562715,847046
BW_21345,BW_21345_idx_598,BW_01161,6676601,324888,3946,6680547,0.99940932980488,921339
BW_21346,BW_21346_idx_471,BW_01161,4975340,246278,3124,4978464,0.999372497220026,719992
BW_21347,BW_21347_idx_479,BW_01161,12082194,604869,7562,12089756,0.999374511776747,1940326
BW_21347,BW_21347_idx_908,BW_01161,9047123,446878,5556,9052679,0.999386259028957,1290164
BW_21348,BW_21348_idx_583,BW_01161,11209586,552331,6798,11216384,0.99939392231935,1648702
BW_25908,BW_25908_idx_977,BW_01161,9547744,470892,5860,9553604,0.999386618913658,1382059
NA,TA2477,BW_01161,445026,23261,992,446018,0.997775874516275,NA
TOWWC162,TOWWC162_idx_209,BW_01161,8837680,429496,4907,8842587,0.999445071900339,1185406
BW_21349,BW_21349_idx_599,BW_01162,12046821,581345,7371,12054192,0.999388511482147,1806982
BW_21351,BW_21351_idx_472,BW_01162,7919043,386527,5073,7924116,0.999359802405719,1525262
BW_21352,BW_21352_idx_480,BW_01162,8895478,433075,5785,8901263,0.999350092228485,1775668
BW_21353,BW_21353_idx_1009,BW_01162,13717616,673177,8339,13725955,0.999392464859458,2129474
BW_21353,BW_21353_idx_584,BW_01162,9611481,473884,6141,9617622,0.999361484574877,1641367
NA,TA2478,BW_01162,591418,21384,894,592312,0.998490660327665,NA
TOWWC163,TOWWC163_idx_210,BW_01162,6772234,318161,3924,6776158,0.999420910787499,867559
BW_21354,BW_21354_idx_592,BW_01163,11693068,586123,7266,11700334,0.999378992086893,1715734
BW_21356,BW_21356_idx_600,BW_01163,11518188,576646,6988,11525176,0.999393675202878,1713353
BW_21357,BW_21357_idx_1010,BW_01163,12824894,647667,7814,12832708,0.999391087212457,1949949
BW_21357,BW_21357_idx_425,BW_01163,5671789,285313,3940,5675729,0.999305816045833,1024831
BW_21358,BW_21358_idx_433,BW_01163,10388488,519152,6390,10394878,0.999385274170606,1617861
BW_25910,BW_25910_idx_978,BW_01163,8292582,406225,4889,8297471,0.999410784322114,1110210
NA,TA2479,BW_01163,573783,21392,946,574729,0.998354006844965,NA
TOWWC164,TOWWC164_idx_211,BW_01163,5861474,286063,3506,5864980,0.999402214500305,739581
BW_21360,BW_21360_idx_449,BW_01164,10617293,499887,6083,10623376,0.999427394831925,1599370
BW_21361,BW_21361_idx_457,BW_01164,5864845,282255,3762,5868607,0.999358962016029,977965
BW_21362,BW_21362_idx_913,BW_01164,3105968,133956,1190,3107158,0.999617013360762,292787
BW_21363,BW_21363_idx_426,BW_01164,10957461,519928,6560,10964021,0.999401679365627,1694049
BW_25912,BW_25912_idx_434,BW_01164,8197295,387105,4983,8202278,0.999392485843567,1108249
NA,TA2480,BW_01164,888808,31378,1246,890054,0.998600084938667,NA
TOWWC165,TOWWC165_idx_212,BW_01164,5186770,239130,2776,5189546,0.999465078448096,660521
BW_21364,BW_21364_idx_442,BW_01165,10141836,474616,5771,10147607,0.999431294491401,1443312
BW_21365,BW_21365_idx_450,BW_01165,8937405,416819,5202,8942607,0.999418290438124,1227019
BW_21366,BW_21366_idx_458,BW_01165,5830622,272455,3187,5833809,0.999453701689582,737099
BW_25915,BW_25915_idx_979,BW_01165,4819079,220877,2463,4821542,0.999489167573361,596517
NA,TA2481,BW_01165,655107,23093,968,656075,0.99852455893,NA
TOWWC166,TOWWC166_idx_213,BW_01165,10983129,522114,6237,10989366,0.999432451335227,1555186
BW_21369,BW_21369_idx_435,BW_01166,8664536,378525,4455,8668991,0.999486099362659,1218438
BW_21369,BW_21369_idx_912,BW_01166,7620087,334278,3855,7623942,0.999494356069341,1086287
NA,TA2483,BW_01166,433300,20768,779,434079,0.99820539579201,NA
BW_21370,BW_21370_idx_443,BW_01167,9189914,336666,2565,9192479,0.99972096754314,1154470
BW_21371,BW_21371_idx_451,BW_01167,12778525,468766,3713,12782238,0.999709518786929,1630455
BW_21372,BW_21372_idx_459,BW_01167,8681084,315052,2385,8683469,0.999725340183745,1073285
BW_21373,BW_21373_A_idx_1011,BW_01167,8458846,311732,2326,8461172,0.999725097185118,1078424
BW_25919,BW_25919_idx_980,BW_01167,5836958,209945,1462,5838420,0.999749589786278,684158
NA,TA2484,BW_01167,681676,22988,338,682014,0.999504409000402,NA
TOWWC168,TOWWC168_idx_214,BW_01167,11593084,431417,3268,11596352,0.999718187236814,1510833
BW_21376,BW_21376_idx_436,BW_01168,9864225,367419,3020,9867245,0.999693936858769,1338104
BW_21377,BW_21377_idx_444,BW_01168,14591870,546748,4414,14596284,0.999697594264403,2011517
BW_21378,BW_21378_idx_452,BW_01168,10366116,381873,3106,10369222,0.999700459687332,1338056
BW_25921,BW_25921_idx_981,BW_01168,7722587,283675,2614,7725201,0.999661626927248,926482
NA,TA2485,BW_01168,1617683,63209,1298,1618981,0.999198261128451,NA
TOWWC169,TOWWC169_idx_215,BW_01168,10094093,370766,2828,10096921,0.999719914615555,1199539
BW_21382,BW_21382_idx_886,BW_01169,5612924,796578,527856,6140780,0.914040887313989,1008936
NA,TA2495,BW_01169,276193,41591,3117,279310,0.988840356593033,NA
BW_21385,BW_21385_A_idx_911,BW_01170,5741197,216108,1746,5742943,0.999695974694508,662452
BW_21385,BW_21385_idx_429,BW_01170,3825639,138155,1201,3826840,0.99968616404135,392298
BW_21386,BW_21386_idx_437,BW_01170,8032262,303340,2594,8034856,0.999677156628569,1071882
BW_21387,BW_21387_idx_445,BW_01170,11980212,450745,3786,11983998,0.999684078718972,1675437
NA,TA2496,BW_01170,826543,27839,470,827013,0.999431689707417,NA
TOWWC171,TOWWC171_idx_216,BW_01170,11828778,442333,3504,11832282,0.999703861013455,1503069
BW_21389,BW_21389_idx_453,BW_01171,7950532,295213,2208,7952740,0.999722359840759,976655
BW_21390,BW_21390_idx_461,BW_01171,10448601,390578,3017,10451618,0.999711336560521,1413832
BW_21391,BW_21391_idx_430,BW_01171,9097212,346866,2898,9100110,0.999681542311027,1307167
BW_21392,BW_21392_idx_438,BW_01171,11004906,409883,3132,11008038,0.999715480633334,1441161
BW_21393,BW_21393_idx_1020,BW_01171,6340424,232789,1737,6342161,0.999726118589547,726600
BW_21393,BW_21393_idx_446,BW_01171,8369610,310873,2506,8372116,0.999700673043708,1099388
BW_25923,BW_25923_idx_454,BW_01171,9289859,350382,2730,9292589,0.999706217503002,1295764
NA,TA2497,BW_01171,942257,31107,521,942778,0.999447377855656,NA
TOWWC172,TOWWC172_idx_217,BW_01171,8000420,291344,2102,8002522,0.999737332805833,940694
BW_25926,BW_25926_idx_462,BW_01172,1966612,72276,714,1967326,0.999637070826086,313084
BW_25932,BW_25932_idx_982,BW_01172,7756262,291271,2256,7758518,0.999709222818069,1006969
NA,TA2499,BW_01172,461628,16038,215,461843,0.999534473836347,NA
TOWWC173,TOWWC173_idx_218,BW_01172,7786689,283353,1988,7788677,0.999744757678358,912023
BW_21408,BW_21408_idx_439,BW_01175,6653818,335911,4135,6657953,0.999378938241228,930049
BW_21409,BW_21409_idx_447,BW_01175,11479061,581840,7105,11486166,0.999381429799987,1741328
BW_21410,BW_21410_idx_455,BW_01175,9047829,449236,5684,9053513,0.999372177407819,1333417
BW_21410,BW_21410_idx_916,BW_01175,7699907,387754,4816,7704723,0.999374928858572,1068579
BW_25933,BW_25933_idx_463,BW_01175,10939312,561459,6995,10946307,0.999360971695751,1649019
BW_25936,BW_25936_idx_432,BW_01175,11417956,583088,7317,11425273,0.999359577666109,1751815
NA,TA2527,BW_01175,250060,13558,440,250500,0.998243512974052,NA
TOWWC176,TOWWC176_idx_219,BW_01175,9773848,484645,5868,9779716,0.999399982576181,1270665
BW_21412,BW_21412_idx_440,BW_01176,6838395,341653,4639,6843034,0.999322084326923,1150868
BW_21413,BW_21413_idx_448,BW_01176,11145464,567604,7784,11153248,0.999302086710526,1919326
BW_21414,BW_21414_idx_456,BW_01176,10157469,499239,6474,10163943,0.999363042472788,1470188
BW_21415,BW_21415_idx_464,BW_01176,9347227,472460,6360,9353587,0.999320046950972,1465912
BW_21416,BW_21416_idx_385,BW_01176,9596312,480081,6707,9603019,0.999301573807154,1578686
BW_21416,BW_21416_idx_915,BW_01176,7726321,375557,4624,7730945,0.999401884245716,1028537
NA,TA2528,BW_01176,648624,34174,1302,649926,0.997996695008355,NA
TOWWC177,TOWWC177_idx_220,BW_01176,10099399,495184,6027,10105426,0.999403587735935,1328714
BW_21417,BW_21417_idx_393,BW_01177,12656061,616361,7213,12663274,0.999430400068734,1944193
BW_21418,BW_21418_idx_401,BW_01177,10026949,483848,5755,10032704,0.999426375979995,1670877
BW_21419,BW_21419_idx_914,BW_01177,9654916,461797,5212,9660128,0.999460462635692,1319434
BW_21420,BW_21420_idx_409,BW_01177,11065583,535341,6163,11071746,0.999443357894952,1659370
BW_25946,BW_25946_idx_983,BW_01177,8463319,402337,4454,8467773,0.999474005739171,1139607
NA,TA2529,BW_01177,1030964,51430,1974,1032938,0.998088946287192,NA
TOWWC178,TOWWC178_idx_221,BW_01177,9612703,469689,5192,9617895,0.999460172938049,1359481
BW_21422,BW_21422_idx_386,BW_01178,9291246,471104,8221,9299467,0.999115970840049,1437245
BW_21423,BW_21423_idx_394,BW_01178,7422900,375436,4952,7427852,0.999333320049996,1055741
BW_25947,BW_25947_idx_402,BW_01178,11800533,590443,7563,11808096,0.999359507239779,1663413
BW_25951,BW_25951_idx_984,BW_01178,12323777,623404,7705,12331482,0.999375176479194,1735289
NA,TA2530,BW_01178,813108,43088,1679,814787,0.997939338747427,NA
TOWWC179,TOWWC179_idx_222,BW_01178,11006205,564504,7055,11013260,0.999359408567491,1598739
BW_21425,BW_21425_idx_418,BW_01179,7460522,263457,2056,7462578,0.999724491991909,1049293
BW_21426,BW_21426_idx_387,BW_01179,6977795,244807,1812,6979607,0.999740386528926,801809
BW_21427,BW_21427_idx_395,BW_01179,11251421,397749,2760,11254181,0.999754757809564,1475285
BW_21428,BW_21428_idx_403,BW_01179,6753592,238292,1635,6755227,0.999757965202354,811788
BW_21429,BW_21429_idx_411,BW_01179,11616482,409808,2848,11619330,0.999754891202849,1439117
BW_21430,BW_21430_idx_1012,BW_01179,5125848,178759,1237,5127085,0.999758732301103,586497
BW_21430,BW_21430_idx_419,BW_01179,11959875,422044,2971,11962846,0.999751647726636,1529182
NA,TA2561,BW_01179,518861,20663,243,519104,0.999531885710763,NA
TOWWC180,TOWWC180_idx_223,BW_01179,9315745,327945,2120,9317865,0.9997724800692,1083401
BW_21435,BW_21435_idx_388,BW_01181,11181425,405658,2965,11184390,0.999734898371748,1602190
BW_21436,BW_21436_idx_396,BW_01181,8977337,321274,2336,8979673,0.999739856896793,1147475
BW_21437,BW_21437_idx_404,BW_01181,9395956,348220,2455,9398411,0.99973878563089,1374217
BW_21438,BW_21438_idx_920,BW_01181,6836375,246805,1744,6838119,0.99974495910352,1000269
BW_21439,BW_21439_idx_412,BW_01181,10602991,383399,2718,10605709,0.99974372293262,1416578
NA,TA2564,BW_01181,1108219,43438,599,1108818,0.999459785104499,NA
TOWWC182,TOWWC182_idx_224,BW_01181,9688327,342345,2255,9690582,0.999767299838132,1174955
BW_21440,BW_21440_idx_420,BW_01182,13766981,492764,3797,13770778,0.999724271206754,1882993
BW_21441,BW_21441_idx_389,BW_01182,11495344,406472,3152,11498496,0.999725877192982,1522943
BW_21442,BW_21442_idx_397,BW_01182,8690724,309324,2338,8693062,0.99973104988783,1092089
BW_21443,BW_21443_idx_1021,BW_01182,2880467,98271,712,2881179,0.99975287894296,303995
BW_21443,BW_21443_idx_405,BW_01182,10719713,382142,2938,10722651,0.999726000594442,1454178
NA,TA2565,BW_01182,2194754,81911,1250,2196004,0.999430784279081,NA
TOWWC183,TOWWC183_idx_225,BW_01182,9317147,321719,2336,9319483,0.999749342318667,1102531
NA,TA2567,BW_01183,1146044,196388,19249,1165293,0.9834814076803,NA
BW_21450,BW_21450_idx_413,BW_01184,5649062,205154,1764,5650826,0.999687833247741,663715
BW_21451,BW_21451_idx_421,BW_01184,8344851,310615,2489,8347340,0.999701821178962,1119989
BW_21452,BW_21452_idx_390,BW_01184,4759893,178821,1556,4761449,0.999673208722807,644467
BW_21453,BW_21453_idx_398,BW_01184,10170913,381989,3138,10174051,0.999691568284845,1413131
BW_21454,BW_21454_idx_406,BW_01184,10245929,384092,2991,10248920,0.999708164372441,1296072
BW_21454,BW_21454_idx_918,BW_01184,5570583,203384,1592,5572175,0.999714294687443,659031
NA,TA2568,BW_01184,776711,31962,563,777274,0.999275673700651,NA
TOWWC185,TOWWC185_idx_226,BW_01184,11556440,436307,3452,11559892,0.999701381293182,1563371
BW_21455,BW_21455_idx_414,BW_01185,12675420,446885,2834,12678254,0.999776467642942,1775776
BW_21456,BW_21456_idx_422,BW_01185,10146063,363044,2366,10148429,0.999766860466778,1462169
BW_21457,BW_21457_idx_391,BW_01185,6736648,237994,1672,6738320,0.999751866934191,1020923
BW_21457,BW_21457_idx_917,BW_01185,5401854,185246,1166,5403020,0.99978419476515,621543
BW_21458,BW_21458_idx_399,BW_01185,11369201,398884,2536,11371737,0.999776990973323,1580500
BW_25957,BW_25957_idx_407,BW_01185,14882692,517210,3338,14886030,0.999775762913282,1992463
NA,TA2578,BW_01185,365768,14663,125,365893,0.999658370069939,NA
TOWWC186,TOWWC186_idx_227,BW_01185,8969682,313645,1935,8971617,0.999784319816595,1072138
BW_21459,BW_21459_idx_415,BW_01186,11463920,478587,98402,11562322,0.991489425739916,1791540
BW_21460,BW_21460_idx_423,BW_01186,13676683,484141,3152,13679835,0.999769587864181,1887918
BW_21461,BW_21461_idx_392,BW_01186,11910662,423275,2751,11913413,0.999769083804952,1676851
BW_21462,BW_21462_idx_400,BW_01186,8882578,308848,2235,8884813,0.999748447153587,1050802
BW_21463,BW_21463_idx_408,BW_01186,9435483,337534,2359,9437842,0.999750048792934,1209839
BW_21463,BW_21463_idx_924,BW_01186,6376563,220769,1426,6377989,0.999776418554501,728041
NA,TA2585,BW_01186,761437,29423,300,761737,0.999606163282078,NA
TOWWC187,TOWWC187_idx_228,BW_01186,12339286,508497,104091,12443377,0.991634827105214,1563059
BW_21475,BW_21475_idx_416,BW_01189,13066366,564776,6757,13073123,0.999483138038248,1872685
BW_21476,BW_21476_idx_424,BW_01189,11050988,479123,5836,11056824,0.999472181161607,1619181
BW_25962,BW_25962_idx_81,BW_01189,13634589,582781,6861,13641450,0.999497047601245,1839735
BW_25966,BW_25966_idx_985,BW_01189,7824651,328481,3706,7828357,0.999526592872553,997979
TOWWC190,TOWWC190_idx_229,BW_01189,4461392,184148,2089,4463481,0.999531979636521,505458
BW_21480,BW_21480_idx_83,BW_01190,10372573,510070,6311,10378884,0.999391938478164,1476071
BW_21481,BW_21481_idx_84,BW_01190,10156914,509480,6990,10163904,0.999312272134802,1567286
BW_21483,BW_21483_idx_85,BW_01190,12443682,613917,7878,12451560,0.999367308192708,1767799
BW_21484,BW_21484_idx_86,BW_01190,8272752,402327,5272,8278024,0.999363133037546,1114672
BW_21484,BW_21484_idx_923,BW_01190,4627650,222357,2859,4630509,0.999382573276502,608985
TOWWC191,TOWWC191_idx_230,BW_01190,8151634,400982,4955,8156589,0.99939251567046,1120690
BW_21492,BW_21492_idx_87,BW_01192,11146322,346154,1536,11147858,0.999862215683049,1409069
BW_21493,BW_21493_idx_88,BW_01192,10034726,318911,1512,10036238,0.999849345940182,1505121
BW_21494,BW_21494_idx_89,BW_01192,15532739,484224,2222,15534961,0.999856967777389,2241387
BW_21495,BW_21495_idx_90,BW_01192,12763331,400781,1798,12765129,0.999859147526045,1759699
BW_21495,BW_21495_idx_922,BW_01192,6396897,197853,923,6397820,0.99985573210875,697738
BW_21496,BW_21496_idx_91,BW_01192,17489004,537787,2282,17491286,0.999869535035903,2286823
BW_24573,BW_24573_idx_92,BW_01192,12625899,397679,1816,12627715,0.999856189342252,1857894
TOWWC193,TOWWC193_idx_231,BW_01192,3579122,102587,529,3579651,0.999852220230408,306431
NA,TA1577,BW_23885,390817,34445,2604,393421,0.993381136238279,NA
NA,TA1592,BW_23886,310136,27465,1960,312096,0.993719881062237,NA
NA,TA1594,BW_23887,400377,59165,6265,406642,0.984593327792014,NA
NA,TA1602,BW_23888,235023,20680,1478,236501,0.993750554965941,NA
NA,TA1625,BW_23890,343645,47767,3395,347040,0.990217266021208,NA
NA,TA1630,BW_23891,431203,39353,3734,434937,0.991414848587267,NA
NA,TA1634,BW_23892,374099,54451,4598,378697,0.987858366979406,NA
NA,TA1652,BW_23893,218951,29409,2022,220973,0.990849560806071,NA
NA,TA1655,BW_23894,382629,36809,2976,385605,0.992282257750807,NA
NA,TA1676,BW_23895,226673,19776,1441,228114,0.993682983069869,NA
NA,TA1694,BW_23896,981488,136265,11777,993265,0.988143144075347,NA
NA,TA1697,BW_23897,557193,36635,11299,568492,0.980124610372705,NA
NA,TA1698,BW_23898,272502,23480,1693,274195,0.993825562099965,NA
NA,TA1707,BW_23900,1418643,202232,17259,1435902,0.987980377490943,NA
NA,TA1717,BW_23901,266498,23593,2027,268525,0.992451354622475,NA
NA,TA2379,BW_23902,127720,10821,638,128358,0.995029526792253,NA
NA,TA2381,BW_23903,311192,27650,2115,313307,0.993249432665086,NA
NA,TA2382,BW_23904,244653,32325,2117,246770,0.991421161405357,NA
NA,TA2384,BW_23905,375032,33378,2644,377676,0.99299929039706,NA
NA,TA2392,BW_23906,281468,38359,2597,284065,0.990857726224632,NA
NA,TA2397,BW_23907,287444,39350,2689,290133,0.990731836778305,NA
NA,TA2398,BW_23908,359108,31913,2495,361603,0.993100167863652,NA
NA,TA2399,BW_23909,401414,59961,4929,406343,0.98786985379347,NA
NA,TA2403,BW_23910,351016,32066,2480,353496,0.992984361916401,NA
NA,TA2405,BW_23911,657863,89159,3711,661574,0.9943906501767,NA
NA,TA2410,BW_23913,528302,77525,5902,534204,0.988951786209014,NA
NA,TA2412,BW_23914,74507,6132,309,74816,0.995869867408041,NA
NA,TA2417,BW_23915,331646,29710,2035,333681,0.993901360880602,NA
NA,TA2419,BW_23916,308968,27429,1877,310845,0.993961620743457,NA
NA,TA2426,BW_23917,216132,18610,1274,217406,0.994139996136261,NA
NA,TA2432,BW_23918,203939,17666,1160,205099,0.994344194754728,NA
NA,TA2433,BW_23919,80348,6571,308,80656,0.996181313231502,NA
NA,TA2437,BW_23920,364287,33359,2530,366817,0.993102827840585,NA
NA,TA2440,BW_23921,318886,28970,2113,320999,0.993417424976402,NA
NA,TA2444,BW_23922,266315,36429,2386,268701,0.991120241457978,NA
NA,TA2445,BW_23923,304703,42391,2873,307576,0.990659219184852,NA
NA,TA2462,BW_23924,352406,31891,2314,354720,0.993476544880469,NA
NA,TA2468,BW_23925,2449549,130851,12152,2461701,0.99506357595825,NA
NA,TA2486,BW_23926,543184,79856,6192,549376,0.988729030754893,NA
NA,TA2488,BW_23927,695720,91455,4775,700495,0.993183391744409,NA
NA,TA2489,BW_23928,199318,26133,1522,200840,0.992421828321052,NA
NA,TA2501,BW_23930,444922,58550,2300,447222,0.994857140301685,NA
NA,TA2502,BW_23931,366594,33398,2487,369081,0.993261641753436,NA
NA,TA2507,BW_23932,376455,47668,2884,379339,0.992397301622032,NA
NA,TA2508,BW_23933,1289606,199850,14166,1303772,0.989134603289532,NA
NA,TA2510,BW_23934,886889,134022,11053,897942,0.987690741718285,NA
NA,TA2511,BW_23935,266241,35766,2298,268539,0.991442583758784,NA
NA,TA2514,BW_23936,1314305,192515,13899,1328204,0.989535493041731,NA
NA,TA2517,BW_23937,510370,72610,5314,515684,0.989695239720449,NA
NA,TA2519,BW_23938,640761,90616,6797,647558,0.989503642916928,NA
NA,TA2520,BW_23939,690950,100567,8118,699068,0.988387395789823,NA
NA,TA2522,BW_23940,389861,54359,4025,393886,0.989781307281802,NA
NA,TA2543,BW_23942,266287,36288,2388,268675,0.991111938215316,NA
NA,TA2546,BW_23943,515395,71583,4873,520268,0.990633673414471,NA
NA,TA2557,BW_23944,482816,64934,2708,485524,0.994422520822864,NA
NA,TA2566,BW_23945,417028,56306,3925,420953,0.99067591868926,NA
NA,TA2571,BW_23946,331340,44248,2974,334314,0.991104171527367,NA
NA,TA2573,BW_23947,104032,13008,723,104755,0.993098181471052,NA
NA,TA2577,BW_23948,504074,70111,4991,509065,0.990195751033758,NA
NA,TA2579,BW_23949,241322,31425,1840,243162,0.99243302818697,NA
NA,TA2581,BW_23950,257070,34015,2168,259238,0.991637028522053,NA
NA,TA2586,BW_23951,1649652,242242,17808,1667460,0.989320283545033,NA
NA,TA2587,BW_23952,276526,36632,2179,278705,0.992181697493766,NA
NA,TA10069,BW_23953,36976,4687,242,37218,0.993497769896287,NA
NA,TA10071,BW_23954,320507,43220,2957,323464,0.990858333539436,NA
NA,TA10072,BW_23955,449391,65124,5246,454637,0.988461123929641,NA
NA,TA10075,BW_23956,33275,4095,156,33431,0.995333672340044,NA
NA,TA10080,BW_23957,583350,82018,5868,589218,0.990041037442848,NA
NA,TA10082,BW_23958,892597,128039,9891,902488,0.98904029748872,NA
NA,TA10100,BW_23959,182204,23154,1158,183362,0.993684623858815,NA
NA,TA10105,BW_23960,405621,54350,3458,409079,0.99154686503096,NA
NA,TA10114,BW_23961,318562,45544,4402,322964,0.986369997894502,NA
NA,TA10118,BW_23962,103253,13407,753,104006,0.992760033075015,NA
NA,TA10119,BW_23963,45398,5451,245,45643,0.994632254672129,NA
NA,TA10120,BW_23964,210211,26867,1503,211714,0.992900800136033,NA
NA,TA10123,BW_23965,388925,54766,3888,392813,0.990102160570042,NA
NA,TA10125,BW_23966,307607,40851,2642,310249,0.991484259417436,NA
NA,TA10127,BW_23967,585678,82036,5907,591585,0.990014959811354,NA
NA,TA10135,BW_23968,137247,17821,1060,138307,0.992335890446615,NA
NA,TA10136,BW_23969,586935,82210,6043,592978,0.989809065429072,NA
NA,TA10139,BW_23970,762605,111269,8846,771451,0.988533296346754,NA
NA,TA10143,BW_23971,478845,66261,5076,483921,0.989510684595213,NA
NA,TA10163,BW_23972,181780,23483,1341,183121,0.992676973148902,NA
NA,TA10165,BW_23973,294930,42422,4055,298985,0.98643744669465,NA
NA,TA10169,BW_23974,255529,33521,2058,257587,0.992010466366703,NA
NA,TA10172,BW_23975,503501,70285,4833,508334,0.990492471485283,NA
NA,TA10175,BW_23976,257710,37647,4128,261838,0.984234526692077,NA
NA,TA10177,BW_23977,229791,31573,2758,232549,0.988140133907263,NA
NA,TA10178,BW_23978,229815,32885,3541,233356,0.984825759783335,NA
NA,TA10182,BW_23979,621494,88574,6437,627931,0.989748873681981,NA
NA,TA10183,BW_23980,267310,37077,3140,270450,0.988389720835644,NA
NA,TA10190,BW_23981,252419,36593,3755,256174,0.985341994113376,NA
NA,TA10196,BW_23982,302001,41752,3180,305181,0.989579954191119,NA
NA,TA10202,BW_23983,314313,43117,2934,317247,0.990751685595136,NA
NA,TA10210,BW_23984,1235190,179256,12005,1247195,0.990374400153945,NA
NA,TA10213,BW_23985,249214,33957,2539,251753,0.989914717997402,NA
NA,TA10292,BW_23986,468365,65843,4938,473303,0.989566937036106,NA
NA,TA10293,BW_23987,453406,65660,5154,458560,0.988760467550593,NA
NA,TA10294,BW_23988,328957,46558,3920,332877,0.988223878489652,NA
NA,TA10295,BW_23989,252920,33905,2239,255159,0.991225079264302,NA
NA,TA10306,BW_23990,290994,42053,4364,295358,0.985224710351506,NA
NA,TA10307,BW_23991,560081,79200,5719,565800,0.989892188052315,NA
NA,TA10312,BW_23992,278035,36376,2358,280393,0.991590374938033,NA
NA,TA10319,BW_23993,547811,81287,7050,554861,0.987294115102701,NA
NA,TA10323,BW_23994,528433,73077,4906,533339,0.99080134773568,NA
NA,TA10328,BW_23995,129360,16350,913,130273,0.992991640631597,NA
NA,TA10918,BW_23996,752146,107727,8407,760553,0.988946200987965,NA
NA,TA10922,BW_23997,530902,75234,5798,536700,0.989196944289175,NA
NA,TA10932,BW_23998,533143,73579,5406,538549,0.9899619161859,NA
NA,TA10957,BW_23999,541399,78385,6683,548082,0.987806569090027,NA
